region_id,2011_Census_350_449_Couple_family_With_children_under_15_and_no_dependent_students,2011_Census_350_449_Couple_family_With_no_children_under_15_and_dependent_students,2011_Census_350_449_Couple_family_With_non_dependent_children_only,2011_Census_350_449_Couple_family_Total,2011_Census_450_549_Couple_family_With_no_children,2011_Census_450_549_Couple_family_With_children_under_15_and_dependent_students,2011_Census_450_549_Couple_family_With_children_under_15_and_no_dependent_students,2011_Census_450_549_Couple_family_With_no_children_under_15_and_dependent_students,2011_Census_450_549_Couple_family_With_non_dependent_children_only,2011_Census_450_549_Couple_family_Total,2011_Census_550_649_Couple_family_With_no_children,2011_Census_550_649_Couple_family_With_children_under_15_and_dependent_students,2011_Census_550_649_Couple_family_With_children_under_15_and_no_dependent_students,2011_Census_550_649_Couple_family_With_no_children_under_15_and_dependent_students,2011_Census_550_649_Couple_family_With_non_dependent_children_only,2011_Census_550_649_Couple_family_Total,2011_Census_650_and_over_Couple_family_With_no_children,2011_Census_650_and_over_Couple_family_With_children_under_15_and_dependent_students,2011_Census_650_and_over_Couple_family_With_children_under_15_and_no_dependent_students,2011_Census_650_and_over_Couple_family_With_no_children_under_15_and_dependent_students,2011_Census_650_and_over_Couple_family_With_non_dependent_children_only,2011_Census_650_and_over_Couple_family_Total,2011_Census_Rent_not_stated_Couple_family_With_no_children,2011_Census_Rent_not_stated_Couple_family_With_children_under_15_and_dependent_students,2011_Census_Rent_not_stated_Couple_family_With_children_under_15_and_no_dependent_students,2011_Census_Rent_not_stated_Couple_family_With_no_children_under_15_and_dependent_students,2011_Census_Rent_not_stated_Couple_family_With_non_dependent_children_only,2011_Census_Rent_not_stated_Couple_family_Total,2011_Census_Total_Couple_family_With_no_children,2011_Census_Total_Couple_family_With_children_under_15_and_dependent_students,2011_Census_Total_Couple_family_With_children_under_15_and_no_dependent_students,2011_Census_Total_Couple_family_With_no_children_under_15_and_dependent_students,2011_Census_Total_Couple_family_With_non_dependent_children_only,2011_Census_Total_Couple_family_Total
10101,79,9,8,146,26,0,21,4,6,57,3,3,12,0,3,21,9,0,4,3,0,16,39,5,32,4,6,86,994,156,1003,101,139,2393
10102,245,13,27,549,79,26,121,15,18,259,30,6,69,8,10,123,15,5,41,3,4,68,23,3,26,3,8,63,999,122,1031,80,112,2344
10103,22,3,0,48,0,0,3,0,0,3,3,3,0,0,0,6,4,0,5,5,0,14,12,0,18,0,0,30,290,36,298,21,17,662
10104,93,17,8,222,8,5,11,0,0,24,0,0,0,0,0,0,10,0,6,0,3,19,29,3,31,3,7,73,1195,151,1018,99,153,2616
10201,765,77,127,1614,151,61,239,26,47,524,31,26,70,20,16,163,41,17,44,11,6,119,63,3,54,11,7,138,2696,404,2516,261,392,6269
10202,577,69,113,1216,52,33,99,3,21,208,16,9,34,3,4,66,15,3,19,0,3,40,72,10,42,9,9,142,2430,451,2515,238,465,6099
10301,108,3,8,200,3,3,14,3,0,23,0,0,3,3,0,6,6,0,0,0,0,6,16,3,13,0,3,35,694,102,757,58,82,1693
10302,19,4,0,32,3,3,0,3,0,9,0,0,0,0,0,0,5,0,9,0,0,14,40,8,41,3,4,96,889,125,874,71,92,2051
10303,89,10,5,155,12,3,14,0,3,32,0,3,3,0,0,6,6,0,9,0,0,15,29,3,25,0,8,65,669,117,706,64,94,1650
10304,183,14,12,339,12,7,59,7,3,88,5,3,13,0,0,21,5,0,11,0,0,16,36,7,32,0,0,75,888,147,1059,87,123,2304
10401,60,6,5,119,6,4,7,0,0,17,0,0,3,0,0,3,3,0,3,0,3,9,18,0,13,0,4,35,716,103,704,54,100,1677
10402,412,56,32,795,44,18,95,4,13,174,3,3,23,3,3,35,10,0,6,5,3,24,38,5,40,4,3,90,1474,252,1535,151,178,3590
10501,6,0,0,10,0,0,0,0,0,0,0,0,0,0,0,0,5,0,9,0,0,14,41,4,51,0,5,101,552,75,659,46,79,1411
10502,8,0,0,12,0,3,4,0,0,7,0,0,0,0,0,0,3,0,0,0,0,3,18,0,11,3,0,32,307,31,277,12,31,658
10503,83,5,11,166,3,0,6,0,0,9,0,0,3,0,0,3,9,0,7,0,3,19,47,9,39,3,8,106,1111,172,1099,87,128,2597
10601,306,13,22,547,29,8,43,6,4,90,8,0,9,0,0,17,15,0,6,0,0,21,39,4,36,7,10,96,1202,168,1378,102,202,3052
10602,378,27,35,664,30,11,71,3,8,123,0,0,7,3,4,14,4,0,6,0,0,10,24,3,23,3,4,57,998,171,1200,103,171,2643
10603,271,33,30,561,33,11,67,0,5,116,5,0,16,6,3,30,10,3,21,0,3,37,42,5,39,3,3,92,1284,213,1442,122,191,3252
10604,158,7,4,259,9,3,19,3,0,34,0,0,3,0,0,3,6,0,5,0,0,11,29,12,33,6,0,80,613,87,731,47,79,1557
10701,167,21,26,338,9,9,44,7,8,77,5,0,10,0,0,15,11,0,3,0,0,14,34,3,25,8,10,80,984,153,951,112,204,2404
10702,0,0,0,0,0,0,0,0,0,0,0,0,0,0,0,0,0,0,0,0,0,0,0,0,0,0,0,0,0,0,0,0,0,0
10703,411,45,54,805,44,35,107,18,19,223,7,0,33,4,0,44,11,5,14,0,0,30,35,5,23,0,4,67,1230,251,1284,152,249,3166
10704,499,56,38,1144,166,42,203,17,24,452,49,6,72,13,10,150,30,13,36,7,6,92,74,8,32,4,10,128,2583,236,1794,224,277,5114
10801,61,8,11,131,3,0,11,0,0,14,0,0,4,0,0,4,5,0,0,0,0,5,21,3,13,5,0,42,551,74,437,56,67,1185
10802,34,3,0,66,0,3,4,0,0,7,3,0,0,0,0,3,3,0,0,0,3,6,14,4,22,4,0,44,705,108,626,54,92,1585
10803,0,0,0,0,0,0,0,0,0,0,0,0,4,0,0,4,0,0,0,0,0,0,0,0,0,0,0,0,10,0,19,0,0,29
10804,369,33,33,697,38,22,65,8,4,137,6,3,11,0,3,23,9,0,13,4,0,26,43,3,23,5,9,83,1317,204,1269,131,161,3082
10805,57,6,5,108,0,0,5,3,3,11,0,0,0,0,0,0,13,0,0,4,0,17,25,5,23,0,5,58,852,137,754,81,123,1947
10901,91,13,7,171,8,5,22,0,3,38,4,0,12,0,0,16,3,0,6,0,3,12,28,0,28,7,6,69,1061,105,906,83,86,2241
10902,3,3,3,12,0,0,3,0,0,3,0,0,0,3,0,3,9,0,0,0,0,9,8,0,12,0,0,20,259,25,235,18,29,566
10903,20,3,0,38,6,0,0,0,0,6,0,0,0,0,0,0,4,0,6,0,0,10,25,3,31,3,5,67,712,79,566,51,55,1463
11001,88,10,7,162,0,3,11,3,0,17,0,0,3,0,0,3,3,0,4,0,0,7,26,5,24,0,3,58,679,96,653,51,77,1556
11002,17,0,0,24,0,0,3,0,0,3,0,0,0,0,0,0,4,0,4,0,3,11,20,3,23,6,5,57,605,93,600,56,75,1429
11003,33,0,0,54,3,0,5,0,0,8,0,0,0,0,0,0,3,3,0,3,0,9,28,5,37,6,0,76,560,99,624,54,77,1414
11004,154,17,14,282,14,3,16,0,0,33,0,5,0,0,0,5,10,3,3,3,3,22,70,11,47,9,7,144,1385,184,1421,124,197,3311
11101,371,48,60,837,63,34,138,27,21,283,18,6,26,8,3,61,18,3,22,4,3,50,28,6,20,0,11,65,1685,240,1492,169,304,3890
11102,192,21,30,444,36,12,58,8,13,127,3,0,5,0,0,8,12,0,7,0,0,19,26,6,16,4,5,57,1029,165,987,105,188,2474
11103,616,44,47,1475,190,24,178,13,23,428,75,13,73,7,7,175,49,9,65,13,4,140,109,9,46,6,16,186,3513,258,2339,198,278,6586
11201,498,44,56,1050,105,25,174,21,11,336,37,15,66,7,3,128,22,10,43,3,3,81,27,5,34,0,5,71,1432,206,1347,129,166,3280
11202,112,9,13,203,8,3,9,0,4,24,0,0,0,0,0,0,4,4,3,0,0,11,38,3,26,3,3,73,968,157,1065,84,127,2401
11203,557,60,69,1199,93,39,163,24,14,333,22,15,48,5,5,95,20,10,34,3,4,71,45,5,25,3,3,81,1611,238,1478,174,200,3701
11301,47,3,3,80,0,0,3,0,0,3,0,0,0,0,4,4,7,0,3,0,0,10,37,12,35,7,3,94,827,137,843,69,116,1992
11302,6,3,0,9,0,0,0,0,0,0,0,0,0,0,0,0,3,0,3,0,0,6,5,0,6,0,0,11,253,45,257,24,24,603
11303,178,17,10,346,30,12,40,0,0,82,5,3,5,0,3,16,9,4,8,0,0,21,52,10,51,4,4,121,1639,187,1543,109,133,3611
11401,150,18,12,320,13,6,12,3,0,34,3,0,8,3,0,14,11,0,11,0,0,22,30,5,33,4,9,81,1461,256,1414,139,192,3462
11402,159,11,24,335,47,19,56,3,10,135,9,6,29,4,5,53,11,3,22,3,4,43,27,0,16,0,6,49,629,119,652,46,104,1550
11501,334,43,40,729,307,101,517,83,72,1080,134,73,313,70,56,646,108,106,325,89,48,676,36,12,36,12,14,110,1122,356,1710,326,263,3777
11502,40,3,14,109,33,3,44,5,8,93,15,11,25,6,12,69,20,20,46,14,10,110,11,3,10,0,3,27,237,61,267,47,57,669
11503,43,3,5,101,9,8,24,6,0,47,7,0,7,0,7,21,8,3,3,3,3,20,9,0,12,3,0,24,171,43,190,27,33,464
11504,48,3,11,107,38,15,72,10,9,144,36,26,103,18,24,207,26,16,44,6,9,101,4,4,8,5,4,25,241,76,359,42,68,786
11601,1029,122,113,2075,101,44,155,25,33,358,11,4,22,5,4,46,13,3,21,6,5,48,72,8,62,12,17,171,2174,433,2602,315,446,5970
11602,475,43,49,892,166,79,344,52,57,698,93,55,230,36,46,460,25,12,56,9,7,109,28,3,28,11,7,77,848,253,1427,199,219,2946
11603,563,56,86,1088,32,18,47,10,24,131,0,0,9,4,4,17,0,5,23,3,7,38,58,12,63,3,24,160,1502,531,2316,258,532,5139
11701,295,32,44,647,103,19,122,18,32,294,148,21,118,11,31,329,38,18,93,7,13,169,33,3,24,3,9,72,999,142,957,111,191,2400
11702,224,23,28,893,366,11,158,20,14,569,206,3,105,10,7,331,127,5,92,7,4,235,37,3,11,3,7,61,1973,69,856,93,97,3088
11703,239,12,26,2402,2877,19,423,23,27,3369,2364,13,392,18,28,2815,2830,30,682,110,87,3739,241,3,44,9,22,319,12311,115,2129,242,277,15074
11801,238,18,24,1218,1255,11,368,30,35,1699,1012,18,344,23,17,1414,1490,138,1367,126,94,3215,129,13,66,12,11,231,5388,201,2567,239,209,8604
11802,479,53,61,1877,1466,48,621,71,69,2275,675,25,397,47,39,1183,598,96,852,111,71,1728,126,7,57,11,5,206,4992,250,2797,356,314,8709
11901,1273,162,184,2560,194,127,467,67,83,938,47,33,134,13,21,248,23,15,58,4,5,105,89,22,95,27,24,257,2213,676,3209,461,584,7143
11902,900,122,135,1895,211,114,409,54,83,871,69,33,130,19,25,276,45,9,69,4,10,137,73,17,76,15,30,211,2854,571,3780,413,501,8119
11903,722,104,114,1889,406,85,445,69,83,1088,144,36,150,37,32,399,72,32,101,25,22,252,80,5,61,19,23,188,2633,331,2088,340,386,5778
11904,1063,105,127,2729,650,90,568,72,91,1471,169,36,210,23,53,491,110,24,125,30,26,315,90,19,66,12,10,197,3388,364,2707,333,413,7205
12001,242,20,21,745,716,30,440,41,43,1270,523,42,376,34,32,1007,375,41,433,72,43,964,52,6,25,5,4,92,2475,150,1698,197,178,4698
12002,101,3,3,434,500,3,179,12,6,700,509,3,236,12,13,773,563,25,531,29,36,1184,48,3,23,6,0,80,2245,46,1176,77,81,3625
12003,1118,125,120,3412,963,64,628,99,82,1836,260,31,273,50,36,650,145,42,231,61,29,508,121,11,45,13,16,206,4833,335,3028,446,385,9027
12101,390,41,35,1295,972,37,556,62,44,1671,439,25,401,32,33,930,470,112,1050,125,63,1820,67,14,60,8,5,154,3144,222,2628,306,215,6515
12102,564,60,46,1260,330,55,532,54,49,1020,52,28,164,34,23,301,30,19,90,24,6,169,26,7,27,3,6,69,1381,169,1569,213,154,3486
12103,107,8,7,299,233,20,187,45,25,510,172,34,260,47,26,539,223,231,994,216,88,1752,25,9,38,4,3,79,991,324,1682,343,174,3514
12104,244,21,14,1592,1408,9,393,23,34,1867,872,8,281,18,27,1206,1084,94,1117,129,79,2503,85,8,62,5,3,163,5265,139,2215,206,173,7998
12201,114,5,3,415,401,9,111,7,6,534,309,6,113,4,8,440,462,61,530,44,18,1115,24,0,24,0,0,48,1655,89,958,73,47,2822
12202,99,8,10,283,143,9,148,20,13,333,91,16,144,30,25,306,162,79,439,68,54,802,23,3,25,5,7,63,730,129,951,134,118,2062
12203,462,43,37,1594,802,42,514,46,60,1464,351,45,413,51,49,909,374,151,936,115,89,1665,67,9,55,6,8,145,3154,310,2663,303,276,6706
12301,264,29,54,558,60,45,203,29,35,372,11,13,35,12,8,79,4,3,9,4,3,23,15,6,9,3,3,36,467,150,691,97,142,1547
12302,592,69,99,1208,59,33,99,20,37,248,7,4,17,3,8,39,8,3,16,0,4,31,72,22,57,15,25,191,2050,525,2497,307,673,6052
12303,88,12,22,185,14,14,40,4,11,83,6,3,6,3,5,23,5,3,10,3,3,24,20,8,20,4,0,52,336,71,442,48,80,977
12401,277,25,21,505,39,15,75,11,9,149,7,4,20,3,0,34,7,0,14,0,0,21,26,3,15,0,5,49,812,106,942,96,91,2047
12402,0,0,0,0,0,0,0,0,0,0,0,0,0,0,0,0,0,0,0,0,0,0,0,0,0,0,0,0,0,0,0,0,0,0
12403,590,58,90,1243,64,33,155,22,39,313,25,16,36,6,14,97,12,17,19,0,0,48,43,9,51,13,17,133,1802,348,2113,203,372,4838
12404,175,15,28,402,16,6,29,10,14,75,13,3,10,0,3,29,8,3,6,0,0,17,14,3,22,0,3,42,669,110,727,69,136,1711
12405,279,31,36,564,14,9,24,9,5,61,0,4,5,0,0,9,5,3,7,0,0,15,30,7,27,0,11,75,650,169,819,92,147,1877
12501,777,87,77,1674,411,75,358,50,41,935,91,21,121,28,20,281,41,12,77,16,10,156,63,13,65,9,16,166,1998,383,2279,291,277,5228
12502,402,57,53,855,156,53,298,60,43,610,64,22,113,23,17,239,22,21,60,14,4,121,38,3,31,9,0,81,954,210,1144,226,186,2720
12503,1253,164,163,2486,148,86,303,46,43,626,32,10,60,8,20,130,17,11,29,0,7,64,79,18,97,21,23,238,2433,558,3074,428,494,6987
12504,1995,145,135,4508,448,58,455,48,63,1072,95,10,89,15,15,224,39,8,35,5,9,96,111,5,84,6,23,229,4681,387,4302,378,390,10138
12601,233,35,14,543,138,43,207,52,28,468,71,30,123,31,23,278,35,20,118,35,21,229,13,5,19,5,8,50,613,136,799,181,117,1846
12602,784,76,69,2169,552,52,589,71,65,1329,231,28,330,47,43,679,167,58,305,53,41,624,74,3,51,4,19,151,3509,236,2582,327,316,6970
12701,474,72,100,986,84,71,182,46,53,436,16,17,40,14,18,105,17,0,15,4,10,46,33,9,42,20,15,119,824,363,1250,252,353,3042
12702,1118,222,298,2516,82,79,201,67,83,512,27,15,32,7,17,98,16,13,19,8,9,65,87,34,92,20,44,277,2393,847,3131,685,992,8048
12703,682,125,151,1473,167,68,254,59,55,603,18,11,48,12,15,104,8,6,20,6,5,45,46,12,62,14,13,147,1693,460,2471,382,474,5480
12801,437,31,50,1285,366,30,348,49,37,830,155,39,213,29,33,469,105,48,226,47,57,483,49,7,28,8,4,96,2074,197,1575,200,227,4273
12802,343,35,39,881,148,48,296,45,36,573,50,21,150,31,31,283,35,27,110,21,18,211,29,3,21,3,3,59,1061,159,1122,166,173,2681
19797,0,0,0,0,0,0,0,0,0,0,0,0,0,0,0,0,0,0,0,0,0,0,0,0,0,0,0,0,0,0,0,0,0,0
20101,123,18,14,247,3,3,16,3,0,25,4,3,0,0,0,7,4,0,7,0,3,14,42,0,32,3,9,86,1525,186,1335,146,148,3340
20102,7,0,0,18,4,3,4,0,0,11,0,0,3,0,0,3,4,0,0,0,0,4,13,0,9,0,3,25,288,36,222,15,15,576
20103,3,0,0,6,0,0,0,0,0,0,3,0,0,0,0,3,6,0,0,0,0,6,11,0,11,0,3,25,265,28,193,6,29,521
20201,110,15,14,231,5,3,16,3,3,30,0,0,3,0,0,3,8,0,9,0,0,17,41,8,28,3,3,83,1384,190,1298,124,153,3149
20202,49,3,3,94,6,0,19,3,0,28,0,0,0,0,0,0,8,0,3,0,3,14,13,0,15,0,0,28,407,58,435,39,44,983
20203,0,0,0,0,0,0,0,0,0,0,0,0,0,0,0,0,0,0,0,0,0,0,6,0,12,0,0,18,135,17,89,14,10,265
20301,16,0,0,23,3,0,5,0,0,8,0,0,0,0,0,0,0,0,0,0,3,3,9,0,6,0,0,15,152,19,136,5,21,333
20302,384,56,47,802,49,16,67,12,15,159,5,3,23,5,3,39,27,7,18,0,0,52,74,11,52,16,20,173,2834,347,2293,272,370,6116
20303,260,28,30,501,44,17,114,7,4,186,4,3,25,0,0,32,8,3,11,3,0,25,21,3,24,3,3,54,895,135,1011,86,91,2218
20401,32,0,0,53,6,0,8,0,0,14,4,0,3,0,0,7,6,0,0,0,0,6,44,3,35,0,8,90,705,81,732,54,97,1669
20402,12,5,0,25,0,3,3,0,0,6,4,0,0,0,0,4,7,0,3,0,0,10,32,3,20,4,3,62,621,82,537,58,68,1366
20403,86,13,9,169,11,6,13,4,0,34,0,0,9,0,0,9,9,0,4,4,0,17,32,5,35,3,7,82,1123,168,1166,122,106,2685
20501,21,4,3,49,0,0,5,0,0,5,0,0,0,0,0,0,5,0,0,0,0,5,17,3,28,4,6,58,542,64,521,54,66,1247
20502,36,0,5,59,4,0,0,3,0,7,3,0,0,0,0,3,11,0,4,0,0,15,31,3,15,3,3,55,670,99,566,64,69,1468
20503,101,6,7,179,28,0,40,0,3,71,6,3,7,0,0,16,12,0,17,0,4,33,41,4,50,4,5,104,855,97,876,71,87,1986
20504,52,6,3,96,3,3,3,3,0,12,3,0,4,0,0,7,9,0,5,0,0,14,26,6,27,3,6,68,994,119,898,67,116,2194
20505,27,0,3,49,3,0,9,0,0,12,4,0,0,0,0,4,11,0,0,0,0,11,25,8,13,0,6,52,611,89,582,41,66,1389
20601,344,25,25,1461,364,11,144,15,11,545,69,9,46,4,3,131,54,0,29,0,0,83,53,4,33,4,5,99,3046,76,1250,94,111,4577
20602,188,10,7,722,252,3,127,6,5,393,56,5,72,0,0,133,48,0,50,4,3,105,32,0,15,0,5,52,1815,41,752,56,47,2711
20603,236,17,24,944,135,8,135,14,11,303,48,9,74,7,8,146,22,12,44,8,3,89,54,4,32,3,3,96,2014,90,1041,90,108,3343
20604,324,14,7,2412,1303,11,258,23,11,1606,539,7,122,14,16,698,542,31,196,59,49,877,105,4,26,13,5,153,5994,120,1290,155,146,7705
20605,288,15,19,2280,1062,8,239,17,10,1336,548,0,194,10,9,761,576,30,456,35,34,1131,111,3,29,8,6,157,6118,68,1567,113,114,7980
20606,141,12,10,1191,532,3,97,6,9,647,299,7,81,10,11,408,253,28,240,42,22,585,60,3,21,3,7,94,3262,53,766,90,77,4248
20607,158,7,12,1325,986,3,187,8,10,1194,417,5,117,9,3,551,266,8,142,21,16,453,71,4,37,8,8,128,4107,88,1081,120,152,5548
20701,531,75,37,2032,463,43,427,77,39,1049,175,44,305,58,24,606,213,122,678,156,54,1223,83,19,62,14,6,184,3840,315,2510,465,215,7345
20702,425,92,86,1049,140,50,232,66,44,532,42,24,82,22,16,186,25,21,49,16,9,120,38,7,30,5,8,88,1065,223,1134,255,238,2915
20703,484,67,46,1269,179,30,227,39,18,493,36,16,67,15,10,144,34,14,52,10,6,116,72,0,27,11,9,119,2103,178,1383,218,170,4052
20801,260,22,24,742,239,23,253,34,17,566,114,34,190,33,17,388,179,112,653,97,35,1076,44,0,34,4,5,87,1457,217,1613,221,132,3640
20802,763,85,68,2183,369,61,491,53,44,1018,131,41,248,24,14,458,110,56,317,58,23,564,94,8,69,11,7,189,4043,274,2717,326,239,7599
20803,439,42,59,1089,167,39,242,35,29,512,46,10,121,8,16,201,39,8,84,10,0,141,44,11,30,10,10,105,2074,161,1531,173,201,4140
20804,128,17,15,540,99,12,88,11,9,219,33,7,49,6,5,100,43,25,168,27,8,271,26,0,20,3,0,49,1123,54,603,71,53,1904
20901,474,50,49,1108,119,17,166,24,18,344,18,9,40,12,5,84,26,9,43,6,10,94,63,5,47,9,9,133,2016,215,1642,182,201,4256
20902,366,29,28,909,50,15,47,9,8,129,15,7,13,3,5,43,46,4,30,3,0,83,61,11,50,7,12,141,2324,184,1614,159,198,4479
20903,145,12,14,265,24,19,56,16,12,127,5,3,16,5,6,35,5,5,13,7,4,34,10,3,11,4,6,34,323,68,368,61,65,885
20904,662,81,89,1312,29,21,68,5,18,141,5,3,11,3,4,26,17,7,39,5,3,71,73,14,84,8,18,197,1857,390,2525,296,388,5456
21001,182,29,25,431,18,11,57,7,8,101,9,0,10,5,0,24,9,0,11,4,4,28,12,0,12,5,4,33,658,79,591,86,85,1499
21002,66,12,3,118,9,4,15,4,3,35,0,0,6,0,0,6,0,3,4,0,0,7,3,3,3,0,3,12,196,38,237,26,36,533
21003,311,28,33,745,24,5,28,9,6,72,3,0,0,0,3,6,22,3,20,5,4,54,33,8,26,4,4,75,1435,152,1314,125,159,3185
21004,83,17,13,181,5,5,7,4,0,21,0,0,4,0,0,4,5,0,0,0,0,5,10,0,6,0,4,20,417,75,412,34,54,992
21005,336,42,50,659,12,15,26,9,13,75,5,0,17,0,3,25,23,5,25,0,5,58,43,18,59,17,21,158,1251,439,2072,248,352,4362
21101,553,88,86,1222,43,25,108,29,21,226,12,13,24,4,6,59,11,5,25,3,0,44,55,9,40,9,6,119,1620,243,1584,236,269,3952
21102,72,9,6,160,11,13,32,3,5,64,3,3,10,3,3,22,7,4,12,0,7,30,4,3,11,3,5,26,167,37,181,26,32,443
21103,356,37,56,843,35,28,61,16,14,154,8,5,22,3,3,41,22,4,17,0,3,46,39,4,18,9,8,78,1610,212,1315,156,183,3476
21104,315,51,34,721,43,17,62,7,11,140,4,3,16,4,0,27,12,3,16,4,3,38,23,3,16,4,7,53,934,115,793,120,109,2071
21105,300,46,31,600,22,19,39,7,7,94,9,9,8,4,3,33,5,0,8,3,3,19,32,4,32,11,10,89,1131,211,1269,162,149,2922
21201,217,26,27,389,15,4,22,0,5,46,6,0,5,0,0,11,9,0,8,0,3,20,42,4,28,4,6,84,860,142,1181,95,138,2416
21202,406,59,60,857,27,18,72,15,8,140,5,4,11,0,3,23,22,8,20,3,4,57,44,16,51,14,22,147,1401,363,1836,224,267,4091
21203,427,42,59,835,30,11,43,4,11,99,5,4,14,0,0,23,21,3,24,3,3,54,47,10,57,7,14,135,1348,311,1913,168,247,3987
21204,436,60,45,979,51,14,78,4,8,155,14,7,12,9,0,42,60,9,52,4,4,129,137,26,110,23,39,335,3643,569,3965,455,485,9117
21205,1113,179,117,2553,272,106,404,77,39,898,62,24,120,29,11,246,63,19,81,20,9,192,108,11,68,10,11,208,3056,469,2867,450,350,7192
21301,258,45,44,573,20,9,29,10,3,71,8,3,10,0,0,21,35,8,41,0,6,90,111,19,102,24,19,275,2400,455,2864,326,398,6443
21302,269,21,21,684,141,14,123,14,20,312,36,9,54,6,6,111,46,5,49,7,6,113,40,9,41,4,5,99,1784,146,1321,126,149,3526
21303,295,23,9,997,176,3,104,9,10,302,29,3,30,3,3,68,36,3,26,4,3,72,43,8,30,10,6,97,2462,141,1450,139,135,4327
21304,308,39,35,582,13,7,24,9,3,56,3,3,10,4,0,20,11,3,16,3,3,36,49,8,43,3,5,108,1322,223,1665,151,218,3579
21305,593,39,52,1077,38,14,99,11,11,173,15,4,32,6,4,61,31,0,49,3,4,87,91,16,66,8,8,189,2684,460,3586,283,336,7349
21401,338,50,58,732,53,10,69,21,16,169,12,0,17,6,4,39,14,7,26,3,3,53,61,5,41,5,11,123,2027,268,1973,200,318,4786
21402,414,43,57,821,57,21,131,23,16,248,24,5,41,15,7,92,35,19,55,9,10,128,81,12,53,3,9,158,1880,236,1932,178,274,4500
21501,21,0,3,45,6,0,5,0,0,11,3,0,3,0,0,6,8,0,4,0,0,12,26,7,31,3,0,67,831,101,715,48,68,1763
21502,33,5,4,63,0,0,3,0,0,3,0,0,0,0,0,0,4,4,4,0,0,12,30,5,9,3,6,53,877,148,832,88,98,2043
21503,4,0,0,11,0,3,3,0,0,6,0,0,0,0,0,0,5,0,5,0,3,13,28,6,38,0,3,75,609,99,560,42,62,1372
21601,10,3,4,32,0,0,3,0,0,3,0,0,3,0,0,3,0,0,5,0,0,5,22,4,16,0,5,47,546,65,496,42,78,1227
21602,14,3,0,23,3,0,3,0,0,6,3,0,0,0,0,3,4,0,0,0,0,4,19,6,17,3,3,48,470,52,398,34,43,997
21603,57,9,6,118,6,0,11,4,0,21,0,0,3,0,0,3,4,3,3,3,3,16,43,6,36,3,6,94,930,175,959,85,124,2273
21701,18,0,0,28,4,3,0,0,0,7,0,0,0,0,0,0,0,0,5,5,0,10,14,3,22,3,3,45,508,66,469,37,53,1133
21702,121,13,9,239,11,5,23,3,0,42,3,3,3,0,0,9,8,5,18,0,0,31,74,5,56,7,4,146,1287,179,1344,110,126,3046
29797,0,0,0,0,0,0,0,0,0,0,0,0,0,0,0,0,0,0,0,0,0,0,0,0,0,0,0,0,0,0,0,0,0,0
30101,556,59,67,1131,94,41,179,25,28,367,16,11,37,5,7,76,11,16,29,7,5,68,30,0,18,5,6,59,942,204,1104,134,176,2560
30102,637,62,79,1347,173,88,338,59,59,717,38,24,76,14,21,173,24,28,71,14,10,147,28,3,35,4,12,82,1291,289,1502,188,231,3501
30103,702,58,92,1588,172,41,232,25,35,505,44,22,116,18,10,210,46,13,72,14,6,151,26,0,28,0,9,63,1430,215,1440,148,204,3437
30201,285,27,36,663,75,14,110,17,24,240,14,3,36,3,7,63,3,3,30,5,3,44,17,3,12,3,3,38,669,73,637,80,97,1556
30202,528,51,64,1513,132,20,124,19,18,313,27,8,27,3,4,69,22,6,47,8,7,90,32,3,16,3,3,57,1866,191,1181,123,180,3541
30203,271,18,44,862,98,8,65,9,10,190,11,6,14,0,5,36,10,0,6,3,3,22,16,3,19,0,3,41,1181,91,662,61,93,2088
30204,577,52,74,1318,36,22,41,17,11,127,7,0,19,5,0,31,5,0,13,0,0,18,34,0,12,4,0,50,1268,169,1082,108,154,2781
30301,409,23,43,1047,181,26,153,27,17,404,38,9,78,17,9,151,27,15,56,11,11,120,16,0,8,3,0,27,1125,100,846,94,108,2273
30302,399,35,37,1527,252,16,140,27,17,452,67,7,49,7,4,134,40,10,76,9,5,140,45,0,25,3,5,78,2913,112,1218,124,119,4486
30303,583,81,62,1567,139,47,141,30,35,392,29,5,54,9,12,109,21,5,25,9,3,63,34,6,21,10,3,74,1527,202,1153,185,179,3246
30304,269,24,20,688,54,12,51,11,0,128,26,5,23,5,0,59,5,3,17,3,0,28,18,3,20,0,0,41,872,89,615,63,55,1694
30305,669,95,104,1504,74,30,108,24,35,271,15,9,28,4,5,61,9,0,9,5,0,23,29,3,19,5,8,64,988,232,1122,174,201,2717
30306,565,64,55,1256,84,28,97,20,20,249,17,6,27,0,7,57,11,3,13,7,3,37,30,8,24,7,0,69,964,180,1007,136,133,2420
30401,232,27,33,537,66,21,85,21,13,206,21,7,37,12,4,81,11,14,29,4,9,67,8,0,11,0,4,23,444,80,498,68,84,1174
30402,233,39,23,457,69,28,123,22,10,252,18,23,89,19,4,153,26,28,86,32,6,178,13,3,14,3,4,37,387,118,609,122,63,1299
30403,268,17,11,968,217,8,157,16,13,411,64,17,72,14,8,175,39,30,115,20,7,211,29,3,16,0,0,48,1624,82,873,93,57,2729
30404,294,29,37,751,76,29,126,22,10,263,19,9,42,5,3,78,12,5,36,4,0,57,18,4,28,3,4,57,938,141,1003,99,94,2275
30501,179,17,10,1266,831,10,165,17,9,1032,415,15,92,14,17,553,410,35,193,43,22,703,64,0,8,7,3,82,3754,81,822,120,82,4859
30502,205,14,18,928,285,8,141,8,3,445,109,4,89,8,0,210,76,23,180,26,6,311,19,0,12,5,0,36,1621,63,788,64,49,2585
30503,301,21,19,1522,467,16,241,19,28,771,194,12,127,9,12,354,140,48,251,27,19,485,49,3,20,3,3,78,3334,121,1378,118,116,5067
30504,208,12,17,1015,351,17,150,13,12,543,135,8,101,11,4,259,103,25,154,27,12,321,23,3,11,3,4,44,2061,69,806,76,60,3072
30601,444,44,39,958,66,18,110,5,5,204,19,6,22,8,3,58,17,6,13,0,0,36,26,0,19,0,4,49,1358,164,1201,98,117,2938
30602,325,35,43,819,54,14,46,7,13,134,17,6,25,3,0,51,18,5,16,0,3,42,46,10,36,7,3,102,2513,340,2106,179,243,5381
30603,54,6,7,114,4,0,15,0,0,19,3,0,0,0,0,3,3,0,0,0,0,3,38,10,11,0,7,66,700,106,755,58,121,1740
30604,49,4,3,114,21,3,18,0,0,42,3,0,0,0,0,3,3,0,0,0,3,6,6,0,9,0,0,15,342,33,228,19,27,649
30605,81,3,3,131,3,0,3,0,0,6,0,0,0,0,0,0,3,3,0,0,0,6,32,3,25,0,9,69,692,93,716,42,72,1615
30701,116,10,12,212,20,4,39,0,0,63,3,3,3,3,5,17,4,0,11,0,0,15,60,8,85,0,11,164,1002,124,1217,53,105,2501
30702,61,6,6,121,7,0,7,0,0,14,3,0,0,0,0,3,3,3,3,0,0,9,44,9,45,5,9,112,775,136,865,63,96,1935
30703,14,0,3,34,0,0,0,0,0,0,0,0,0,0,0,0,7,0,0,0,0,7,25,3,18,6,0,52,689,85,716,54,78,1622
30801,106,8,18,247,87,10,125,10,11,243,40,12,71,3,4,130,39,4,61,9,8,121,59,5,101,9,10,184,962,157,1296,88,122,2625
30802,544,31,54,1036,111,37,256,15,16,435,46,11,64,5,4,130,17,11,45,4,0,77,90,9,82,7,12,200,1534,228,1929,121,191,4003
30803,512,32,53,986,51,15,88,9,13,176,8,0,16,4,0,28,10,4,12,0,4,30,69,11,58,6,13,157,2145,256,2294,142,303,5140
30901,318,41,56,1053,196,25,175,16,28,440,87,16,62,11,9,185,62,22,66,23,12,185,42,0,16,0,7,65,1871,100,882,105,142,3100
30902,394,41,59,912,100,39,159,23,21,342,27,14,40,9,9,99,21,5,22,5,4,57,25,3,15,4,3,50,1239,122,900,105,151,2517
30903,540,37,86,1383,195,36,134,28,35,428,66,12,60,21,14,173,60,14,81,25,28,208,34,3,23,3,9,72,2149,176,1324,141,250,4040
30904,84,7,8,183,24,3,29,5,4,65,6,0,8,0,0,14,10,0,8,0,0,18,8,0,9,0,0,17,244,43,247,24,21,579
30905,214,18,30,454,57,26,149,29,20,281,13,10,42,5,10,80,12,9,34,3,9,67,7,4,13,4,4,32,399,98,580,74,96,1247
30906,750,70,97,1493,107,57,191,34,38,427,27,13,50,16,18,124,14,12,42,13,13,94,26,3,21,8,11,69,1065,217,1365,164,240,3051
30907,1881,129,173,3752,276,107,421,52,77,933,91,45,140,17,23,316,88,45,128,35,15,311,43,8,48,12,6,117,2419,518,3069,277,359,6642
30908,615,76,100,1536,185,69,313,56,61,684,51,24,81,18,17,191,30,14,54,16,7,121,20,0,10,3,7,40,1230,203,1187,184,227,3031
30909,483,57,85,1298,208,39,200,38,46,531,52,11,73,11,17,164,26,5,17,6,6,60,45,3,20,0,9,77,1869,138,1140,147,219,3513
30910,148,12,14,635,196,16,69,20,21,322,92,10,54,21,11,188,106,24,95,25,11,261,41,0,12,3,0,56,1535,74,536,94,75,2314
31001,582,67,67,1244,45,14,58,8,13,138,3,3,14,8,4,32,4,3,10,0,0,17,43,5,26,3,10,87,1378,306,1635,177,231,3727
31002,80,8,12,176,16,0,12,3,0,31,4,0,0,0,0,4,9,0,3,0,0,12,39,7,23,5,3,77,862,140,825,80,100,2007
31003,193,22,33,397,23,11,29,0,4,67,4,0,9,3,3,19,12,3,18,0,0,33,45,7,41,4,10,107,1881,315,2171,164,282,4813
31004,709,46,62,1327,31,15,80,13,6,145,9,7,16,3,3,38,10,7,9,3,0,29,38,7,40,4,8,97,1554,347,2473,140,246,4760
31101,65,3,3,116,3,0,6,0,0,9,3,0,0,3,0,6,7,0,0,0,0,7,8,0,13,0,0,21,238,57,278,34,24,631
31102,361,30,38,663,10,9,27,4,6,56,3,0,4,0,3,10,4,3,3,3,0,13,9,7,18,4,0,38,832,121,1008,92,139,2192
31103,790,70,107,1465,46,17,53,10,15,141,7,7,7,0,6,27,6,0,9,5,0,20,28,3,30,6,10,77,1140,314,1863,160,260,3737
31104,203,19,31,383,53,21,69,9,17,169,4,3,16,3,3,29,0,0,0,3,0,3,10,3,16,0,0,29,293,78,429,40,62,902
31105,535,54,71,1074,40,23,74,15,18,170,10,0,16,3,8,37,3,0,7,3,0,13,22,6,22,6,10,66,959,194,1175,113,196,2637
31106,413,39,62,861,44,22,88,18,14,186,10,6,12,3,0,31,6,9,11,0,3,29,42,10,39,3,8,102,1444,367,1890,193,268,4162
31201,82,6,12,182,21,3,61,5,4,94,9,0,9,0,3,21,90,5,144,6,18,263,82,10,108,6,9,215,1315,195,1840,102,169,3621
31202,889,52,100,1897,326,78,547,37,42,1030,51,17,89,13,18,188,39,4,56,6,4,109,64,4,62,13,3,146,2453,271,2575,177,327,5803
31203,127,7,12,291,37,3,49,3,6,98,11,0,10,0,0,21,10,0,15,0,0,25,14,0,10,0,4,28,565,30,412,22,47,1076
31301,173,18,32,366,39,13,27,5,7,91,4,0,9,0,0,13,7,0,3,0,0,10,27,6,14,0,4,51,795,100,561,65,96,1617
31302,267,29,32,508,15,6,23,0,10,54,3,3,3,3,3,15,11,0,3,0,3,17,26,3,34,6,5,74,1346,251,1705,121,216,3639
31303,32,3,0,59,4,4,3,0,3,14,3,0,0,0,3,6,0,3,0,0,0,3,8,0,7,0,0,15,177,28,180,13,27,425
31304,373,32,65,754,31,20,53,10,8,122,5,5,16,0,0,26,6,0,5,0,3,14,24,0,21,6,3,54,848,224,1137,110,190,2509
31305,391,45,81,894,39,21,68,7,16,151,19,3,21,7,8,58,17,3,16,3,4,43,39,4,22,3,5,73,1519,190,1226,134,266,3335
31401,474,45,62,983,63,37,141,28,13,282,25,13,62,3,12,115,13,9,38,4,9,73,15,5,29,3,4,56,767,181,1110,108,134,2300
31402,868,66,73,1636,67,34,129,11,12,253,16,12,39,6,3,76,5,0,12,0,4,21,30,3,15,0,3,51,1233,208,1560,102,148,3251
31403,296,23,42,558,3,0,20,3,0,26,3,0,0,0,0,3,3,3,3,0,0,9,9,3,11,0,3,26,575,94,682,56,109,1516
31501,35,0,3,65,33,6,19,3,3,64,4,3,24,0,8,39,10,0,19,3,0,32,50,9,55,3,9,126,915,167,1560,55,196,2893
31502,131,3,8,299,99,15,91,9,12,226,33,3,32,5,4,77,13,3,15,0,0,31,62,4,57,0,5,128,1052,110,1102,36,97,2397
31503,12,3,0,18,0,0,0,0,0,0,4,0,0,0,0,4,4,0,3,0,0,7,44,7,56,3,3,113,534,65,607,19,47,1272
31601,515,68,51,1024,82,56,184,22,22,366,12,14,52,10,4,92,16,4,28,3,0,51,22,3,3,3,3,34,740,169,907,119,108,2043
31602,865,57,116,1816,159,42,264,26,36,527,38,16,62,9,11,136,21,17,42,12,7,99,38,4,19,4,4,69,1761,244,1665,159,245,4074
31603,479,44,67,1205,97,29,142,18,25,311,34,9,33,10,3,89,31,6,36,9,5,87,30,3,15,3,4,55,1834,134,1094,107,144,3313
31604,339,25,42,662,27,12,74,7,15,135,14,4,16,0,0,34,5,3,17,0,3,28,21,3,19,0,5,48,817,117,908,72,131,2045
31605,378,37,40,797,131,39,210,24,22,426,42,15,76,10,5,148,38,6,53,5,3,105,21,3,18,0,8,50,951,139,893,86,107,2176
31606,300,29,33,576,24,14,54,6,8,106,10,4,4,0,3,21,7,0,11,0,0,18,20,4,19,4,7,54,650,123,722,74,104,1673
31701,458,37,36,842,30,16,52,10,4,112,5,0,13,0,0,18,19,3,12,0,0,34,69,10,53,8,11,151,2683,383,2956,222,348,6592
31801,27,4,4,50,5,0,10,0,3,18,3,0,0,0,0,3,4,0,0,0,0,4,36,10,35,3,4,88,801,147,930,77,119,2074
31802,1313,138,127,3007,207,46,233,30,25,541,32,14,76,12,7,141,34,3,36,5,4,82,104,17,105,11,10,247,4618,573,4303,355,442,10291
31901,93,14,8,205,16,0,15,4,0,35,0,3,0,0,0,3,4,3,0,0,3,10,44,3,34,5,7,93,1628,222,1570,133,209,3762
31902,40,5,3,73,0,0,0,0,0,0,0,0,3,0,0,3,6,0,4,0,0,10,31,0,37,0,4,72,866,102,929,53,107,2057
31903,33,3,0,69,0,3,3,0,0,6,0,3,0,3,0,6,3,0,0,3,0,6,35,4,20,3,3,65,742,122,804,62,82,1812
31904,80,11,5,189,4,0,15,3,3,25,3,0,3,0,3,9,5,0,5,3,0,13,29,3,21,0,9,62,1209,200,1180,108,149,2846
31905,24,4,0,40,0,0,0,0,0,0,3,0,0,0,0,3,0,0,4,0,0,4,24,0,20,3,0,47,695,103,694,46,73,1611
39797,0,0,0,0,0,0,0,0,0,0,0,0,0,0,0,0,0,0,0,0,0,0,0,0,0,0,0,0,0,0,0,0,0,0
40101,75,3,3,423,119,0,35,5,7,166,41,0,12,3,0,56,39,4,17,4,3,67,18,0,3,3,0,24,975,7,257,25,19,1283
40102,189,18,15,355,22,9,41,9,5,86,5,3,16,3,0,27,4,4,11,6,0,25,27,3,6,3,4,43,787,115,734,97,83,1816
40103,110,28,10,270,52,17,79,16,7,171,18,9,44,10,0,81,14,21,54,9,4,102,14,3,3,3,5,28,664,110,500,90,42,1406
40104,177,32,26,375,20,11,31,9,3,74,0,0,10,0,0,10,4,0,8,0,0,12,34,4,10,0,4,52,860,109,825,109,83,1986
40105,123,17,9,362,63,3,47,4,6,123,14,3,25,3,3,48,13,5,32,0,3,53,26,3,12,0,0,41,1095,55,554,63,36,1803
40106,63,10,4,182,19,6,47,10,3,85,7,0,21,4,3,35,3,0,17,4,3,27,19,0,5,0,3,27,608,31,420,44,35,1138
40107,92,18,5,295,58,13,80,7,6,164,29,5,37,3,5,79,18,4,45,5,7,79,21,0,7,3,0,31,929,59,518,58,45,1609
40201,42,9,7,93,5,3,3,0,0,11,3,0,0,0,0,3,3,0,0,0,0,3,15,4,8,0,3,30,434,66,399,44,63,1006
40202,53,6,9,108,0,3,5,0,4,12,0,0,0,0,0,0,0,0,4,0,0,4,43,0,35,4,12,94,1517,222,1435,126,242,3542
40203,187,23,12,454,11,3,12,0,0,26,4,0,5,0,0,9,7,0,7,0,0,14,49,9,27,7,3,95,1583,181,1295,111,155,3325
40204,176,8,25,372,25,13,46,4,9,97,9,6,3,0,0,18,7,0,11,4,5,27,57,7,46,8,12,130,2017,323,1924,201,323,4788
40205,175,26,22,344,8,5,15,0,3,31,0,4,3,0,3,10,3,4,3,0,0,10,32,0,19,0,5,56,1031,150,959,107,152,2399
40301,118,18,16,312,60,9,49,14,6,138,22,9,24,4,11,70,24,11,29,3,6,73,15,0,8,0,0,23,882,57,441,62,65,1507
40302,323,44,37,713,26,14,36,11,0,87,8,4,10,0,4,26,6,4,14,0,5,29,40,3,26,7,4,80,1671,160,1213,163,170,3377
40303,137,23,11,325,22,18,48,14,11,113,8,6,20,5,6,45,4,5,20,5,0,34,28,3,12,0,0,43,777,99,631,84,68,1659
40304,343,39,40,680,16,17,37,3,4,77,4,0,11,0,5,20,17,3,8,3,3,34,72,4,43,3,9,131,2144,349,2053,203,290,5039
40401,283,38,45,729,53,14,72,8,12,159,20,9,26,10,0,65,23,5,18,3,5,54,45,3,28,9,11,96,2098,232,1543,191,269,4333
40402,150,8,15,329,20,3,21,5,3,52,4,9,6,3,0,22,6,3,3,0,3,15,27,3,20,0,6,56,1216,136,869,93,150,2464
40403,171,18,22,492,41,4,43,5,0,93,17,3,8,3,0,31,11,3,11,5,0,30,40,3,23,3,5,74,1681,114,995,93,110,2993
40501,31,3,0,47,0,0,5,0,0,5,3,0,3,0,0,6,3,0,0,0,0,3,11,3,12,0,3,29,443,49,389,35,56,972
40502,6,0,0,10,0,0,0,0,0,0,3,0,3,0,0,6,6,0,0,0,0,6,25,0,14,0,0,39,373,40,301,25,32,771
40503,6,0,0,17,3,0,0,0,0,3,0,0,0,0,0,0,6,0,0,0,0,6,25,4,11,0,0,40,467,45,315,23,25,875
40504,8,0,3,11,0,0,0,0,0,0,0,0,3,0,0,3,4,0,3,0,0,7,21,0,10,4,0,35,415,36,345,25,30,851
40601,67,5,10,128,5,3,3,0,0,11,0,0,0,0,0,0,9,0,4,0,0,13,55,3,26,6,6,96,1283,137,1017,67,126,2630
40602,42,4,3,120,30,0,36,0,6,72,8,4,17,0,0,29,11,0,7,0,0,18,34,9,40,3,4,90,897,93,861,53,90,1994
40701,26,4,5,65,0,0,5,0,0,5,0,0,3,0,0,3,6,0,3,0,0,9,22,6,13,0,3,44,863,99,593,59,62,1676
40702,12,0,0,23,0,0,3,0,0,3,0,0,0,0,0,0,7,0,6,0,0,13,50,7,35,3,3,98,1140,139,978,81,100,2438
40703,7,0,0,16,3,0,3,0,0,6,0,0,0,0,0,0,3,3,3,3,3,15,40,10,48,7,9,114,1270,162,1083,99,146,2760
49797,0,0,0,0,0,0,0,0,0,0,0,0,0,0,0,0,0,0,0,0,0,0,0,0,0,0,0,0,0,0,0,0,0,0
50101,254,13,17,482,15,9,26,4,0,54,3,0,3,0,0,6,7,3,3,0,0,13,26,3,28,0,3,60,1057,143,1066,82,78,2426
50102,492,36,41,907,35,9,68,3,5,120,12,0,18,0,4,34,17,4,20,6,3,50,51,7,28,3,4,93,1810,241,1848,115,218,4232
50103,13,3,0,16,0,0,0,0,0,0,0,0,0,0,0,0,6,0,3,0,0,9,13,0,18,3,3,37,314,32,351,21,29,747
50201,474,38,69,950,32,21,59,9,15,136,12,3,17,3,3,38,22,3,15,3,3,46,40,4,27,0,0,71,1847,250,1753,142,231,4223
50301,147,15,5,455,166,21,126,25,17,355,102,18,106,22,8,256,177,117,565,107,31,997,35,7,22,9,3,76,1228,199,1253,191,82,2953
50302,300,13,27,1548,897,10,252,21,21,1201,363,10,161,20,10,564,379,30,310,45,16,780,81,3,35,0,5,124,4589,110,1594,136,120,6549
50401,463,48,61,1194,118,23,104,17,14,276,28,4,26,0,5,63,15,4,19,5,3,46,46,5,27,7,3,88,2011,163,1303,126,177,3780
50402,116,20,17,259,20,9,61,8,6,104,10,0,12,0,0,22,9,0,5,0,0,14,11,0,13,0,5,29,401,54,375,41,65,936
50403,711,61,87,1443,67,49,139,22,28,305,21,5,39,5,7,77,12,0,25,3,4,44,32,13,39,3,4,91,1367,273,1651,152,225,3668
50501,942,93,133,2086,195,109,413,63,55,835,67,41,200,28,15,351,77,49,180,42,18,366,42,6,29,3,9,89,1933,357,2171,272,286,5019
50502,1090,79,82,2916,401,56,344,35,36,872,125,34,166,27,23,375,126,50,217,26,24,443,102,8,89,5,15,219,4784,466,3486,299,326,9361
50503,1406,120,154,2731,135,94,418,60,53,760,23,27,99,8,17,174,24,20,57,10,11,122,45,12,49,4,12,122,1955,508,2874,265,353,5955
50601,201,19,26,395,47,19,85,9,9,169,5,9,11,3,0,28,8,0,0,4,0,12,23,0,22,3,5,53,831,129,975,73,124,2132
50602,493,46,61,1454,213,7,135,17,20,392,90,4,32,6,12,144,62,3,38,5,3,111,51,4,27,0,3,85,2420,157,1477,122,190,4366
50603,702,89,49,1656,109,41,191,42,29,412,24,12,42,6,3,87,17,13,28,9,3,70,60,6,32,5,5,108,1764,340,1709,205,151,4169
50604,649,57,85,1317,93,43,191,27,32,386,7,4,19,8,4,42,15,8,16,0,4,43,37,8,43,5,8,101,1406,284,1853,173,255,3971
50605,267,24,36,548,41,17,76,10,15,159,11,3,14,0,0,28,4,3,9,3,3,22,17,4,10,4,3,38,567,93,608,69,92,1429
50606,91,9,3,161,12,5,17,4,3,41,5,3,5,0,0,13,3,0,8,0,0,11,6,0,9,0,0,15,178,28,221,17,26,470
50607,168,16,29,686,194,14,115,16,9,348,65,10,63,8,11,157,102,10,128,22,12,274,21,0,14,6,0,41,1525,74,729,90,91,2509
50701,620,56,77,1428,98,39,225,31,22,415,22,4,32,6,4,68,26,4,28,7,9,74,39,5,31,0,13,88,1443,209,1435,139,194,3420
50702,112,9,11,383,160,7,67,4,8,246,69,6,41,4,0,120,53,11,64,8,10,146,21,3,13,0,0,37,947,49,465,40,59,1560
50703,146,3,13,298,10,6,8,0,0,24,0,0,3,3,0,6,5,0,0,0,0,5,15,0,6,0,6,27,516,81,523,19,72,1211
50704,475,70,45,1206,191,64,304,68,27,654,71,31,111,35,13,261,83,52,188,48,24,395,33,5,32,10,7,87,1639,250,1472,256,173,3790
50705,878,67,83,1621,38,23,125,4,17,207,9,5,23,3,0,40,9,4,20,0,0,33,51,4,34,3,5,97,1883,349,2429,158,249,5068
50801,59,5,5,106,5,0,8,0,3,16,0,0,0,0,5,5,4,0,0,0,0,4,11,0,32,4,5,52,370,57,459,21,50,957
50802,33,0,6,64,12,0,15,0,5,32,4,0,5,0,0,9,12,0,4,0,0,16,20,3,26,0,0,49,347,20,332,11,27,737
50803,225,7,20,432,56,18,95,3,3,175,16,7,39,3,7,72,5,0,13,3,3,24,37,10,53,3,3,106,1151,133,1307,72,136,2799
50804,59,4,3,150,78,4,54,3,10,149,73,6,58,6,3,146,125,12,101,7,5,250,84,10,92,3,11,200,1304,129,1507,61,134,3135
50805,234,18,27,461,30,3,46,6,0,85,4,3,3,0,0,10,9,0,7,0,0,16,65,3,63,6,3,140,1193,138,1219,86,132,2768
50806,37,3,6,85,32,3,38,3,5,81,18,5,23,3,4,53,384,29,309,18,57,797,259,28,337,26,33,683,2462,303,3082,169,384,6400
50901,122,6,15,237,0,3,9,3,0,15,3,0,3,0,0,6,4,4,5,0,0,13,62,4,39,5,7,117,1151,170,1223,99,108,2751
50902,64,7,13,133,3,3,19,0,0,25,3,0,3,0,0,6,3,0,3,0,3,9,68,5,54,0,6,133,948,114,979,60,99,2200
50903,20,0,4,44,9,3,11,0,0,23,0,0,6,0,0,6,0,0,0,0,0,0,23,3,40,3,3,72,432,43,477,24,35,1011
59797,0,0,0,0,0,0,0,0,0,0,0,0,0,0,0,0,0,0,0,0,0,0,0,0,0,0,0,0,0,0,0,0,0,0
60101,23,0,4,39,4,0,0,3,0,7,0,0,0,0,0,0,0,0,0,0,0,0,5,4,7,0,0,16,199,49,278,23,47,596
60102,110,22,13,248,18,5,31,9,3,66,5,0,4,0,0,9,3,3,6,0,0,12,21,3,14,0,4,42,679,86,588,71,88,1512
60103,70,9,9,147,3,5,4,0,0,12,0,4,0,0,0,4,7,0,5,3,0,15,23,3,11,0,8,45,851,141,812,80,115,1999
60104,123,18,7,251,14,4,31,3,3,55,0,0,4,0,0,4,3,0,3,0,0,6,8,0,9,0,0,17,431,66,460,42,34,1033
60105,170,15,16,478,91,12,56,12,3,174,25,5,20,4,4,58,26,3,17,0,3,49,24,3,6,3,3,39,1321,80,580,64,49,2094
60106,25,0,3,47,0,0,5,0,0,5,0,0,0,0,0,0,0,0,0,0,0,0,6,0,5,0,0,11,200,26,202,11,25,464
60201,103,16,8,205,14,3,25,3,3,48,0,0,7,0,0,7,9,0,4,0,5,18,27,3,18,0,3,51,1452,185,1185,118,157,3097
60202,10,0,3,23,0,0,0,0,0,0,0,0,0,0,0,0,4,0,0,3,0,7,13,0,13,0,3,29,244,36,266,23,44,613
60203,15,4,3,30,0,4,3,0,0,7,0,0,0,0,0,0,3,0,3,0,0,6,30,3,14,5,4,56,585,63,535,47,66,1296
60301,0,0,0,0,0,0,0,0,0,0,0,0,0,0,0,0,3,0,0,0,0,3,15,0,10,0,8,33,144,22,147,4,27,344
60302,11,0,3,23,0,0,0,0,0,0,0,0,4,0,0,4,3,0,0,0,0,3,16,3,3,0,0,22,194,38,227,19,18,496
60303,0,0,0,3,0,0,0,0,0,0,0,0,0,0,0,0,0,0,0,0,0,0,4,0,3,0,0,7,116,8,100,6,7,237
60401,10,5,3,30,0,0,0,0,3,3,0,0,0,0,0,0,3,0,6,0,0,9,16,3,13,3,9,44,733,78,706,63,110,1690
60402,13,3,5,48,0,0,0,0,3,3,0,0,0,0,0,0,0,0,0,0,0,0,20,0,16,3,0,39,729,106,640,58,89,1622
60403,0,3,0,3,0,0,0,0,0,0,0,0,0,0,0,0,0,0,3,0,0,3,16,0,28,3,0,47,300,41,350,22,22,735
69797,0,0,0,0,0,0,0,0,0,0,0,0,0,0,0,0,0,0,0,0,0,0,0,0,0,0,0,0,0,0,0,0,0,0
70101,101,10,0,420,245,10,73,8,14,350,194,4,65,9,7,279,214,11,138,22,10,395,32,3,18,7,4,64,1358,51,661,69,51,2190
70102,307,24,27,760,318,36,242,19,32,647,84,24,90,8,13,219,59,14,81,7,13,174,35,4,41,4,9,93,1507,186,1409,124,170,3396
70103,22,3,0,80,45,10,40,3,9,107,12,3,25,4,5,49,9,6,9,0,0,24,8,0,10,0,0,18,254,30,200,10,24,518
70104,192,8,12,455,238,21,192,14,30,495,89,13,136,4,9,251,28,9,42,4,7,90,35,10,48,3,0,96,939,114,1078,60,86,2277
70201,114,10,12,329,120,8,122,10,16,276,32,4,46,4,6,92,20,3,27,0,4,54,119,19,184,5,9,336,1217,119,1399,57,151,2943
70202,9,0,0,19,5,0,0,0,0,5,0,0,0,0,0,0,0,0,0,0,0,0,33,3,44,0,0,80,218,27,300,3,35,583
70203,5,0,0,13,4,0,4,3,0,11,3,0,0,0,0,3,3,0,3,0,0,6,39,14,99,3,11,166,545,143,1081,41,118,1928
70204,12,0,0,16,0,0,0,0,3,3,0,0,4,0,0,4,4,0,3,0,0,7,42,21,105,8,13,189,562,172,1155,61,129,2079
70205,33,0,5,88,7,3,7,0,3,20,0,0,3,0,0,3,0,0,3,0,0,3,42,0,62,4,5,113,633,107,1075,29,73,1917
79797,0,0,0,0,0,0,0,0,0,0,0,0,0,0,0,0,0,0,0,0,0,0,0,0,0,0,0,0,0,0,0,0,0,0
80101,678,72,78,1895,339,39,318,30,25,751,47,24,85,14,12,182,27,11,34,4,6,82,47,11,28,8,4,98,2010,226,1571,165,175,4147
80102,3,0,0,6,0,0,0,3,0,3,0,0,0,0,0,0,0,0,0,0,0,0,3,0,0,0,0,3,21,6,18,3,0,48
80103,0,0,0,8,0,0,3,0,3,6,0,0,0,0,0,0,0,0,0,0,0,0,0,0,0,0,0,0,36,0,28,0,10,74
80104,371,29,20,926,245,39,339,26,21,670,83,24,171,21,12,311,30,16,62,7,8,123,20,0,33,5,6,64,1126,179,1462,134,87,2988
80105,138,17,21,860,487,11,157,13,20,688,151,5,62,13,6,237,73,10,58,11,4,156,26,3,21,3,3,56,1886,74,695,90,74,2819
80106,88,7,5,409,206,11,72,9,3,301,96,7,68,11,3,185,88,22,133,22,7,272,15,4,5,3,3,30,866,61,436,55,31,1449
80107,620,58,99,1429,207,41,274,28,42,592,45,16,61,10,10,142,18,4,16,4,3,45,22,5,33,4,6,70,1274,199,1333,143,208,3157
80108,96,7,12,268,62,11,83,5,9,170,11,4,26,4,3,48,7,5,10,4,3,29,3,0,8,0,0,11,346,48,307,27,41,769
80109,238,19,19,582,190,24,148,15,8,385,41,14,77,7,4,143,34,10,61,11,3,119,19,0,12,0,0,31,879,84,684,77,46,1770
89797,0,0,0,0,0,0,0,0,0,0,0,0,0,0,0,0,0,0,0,0,0,0,0,0,0,0,0,0,0,0,0,0,0,0
90101,0,0,0,3,0,0,0,0,3,3,0,0,3,0,0,3,0,0,0,3,0,3,0,0,0,3,3,6,57,6,56,10,6,135
90102,0,0,0,0,0,0,0,0,0,0,0,0,0,0,0,0,0,0,3,0,0,3,4,0,13,3,0,20,42,0,42,7,7,98
90103,4,0,0,4,0,0,0,0,0,0,0,0,0,0,0,0,0,0,0,0,0,0,0,0,3,0,0,3,9,3,17,3,6,38
99797,0,0,0,0,0,0,0,0,0,0,0,0,0,0,0,0,0,0,0,0,0,0,0,0,0,0,0,0,0,0,0,0,0,0
