region_id,2011_Census_Other_tenure_type_Dwelling_structure_Flat_unit_or_apartment,2011_Census_Other_tenure_type_Dwelling_structure_Other_dwelling,2011_Census_Other_tenure_type_Dwelling_structure_Not_stated,2011_Census_Other_tenure_type_Total,2011_Census_Tenure_type_not_stated_Dwelling_structure_Separate_house,2011_Census_Tenure_type_not_stated_Dwelling_structure_Semi_detached_row_or_terrace_house_townhouse_etc,2011_Census_Tenure_type_not_stated_Dwelling_structure_Flat_unit_or_apartment,2011_Census_Tenure_type_not_stated_Dwelling_structure_Other_dwelling,2011_Census_Tenure_type_not_stated_Dwelling_structure_Not_stated,2011_Census_Tenure_type_not_stated_Total,2011_Census_Total_Dwelling_structure_Separate_house,2011_Census_Total_Dwelling_structure_Semi_detached_row_or_terrace_house_townhouse_etc,2011_Census_Total_Dwelling_structure_Flat_unit_or_apartment,2011_Census_Total_Dwelling_structure_Other_dwelling,2011_Census_Total_Dwelling_structure_Not_stated,2011_Census_Total_Total
10101,12,6,0,238,1174,72,76,69,0,1391,23981,1067,835,409,45,26337
10102,20,3,0,126,742,138,283,101,0,1264,15123,2343,2690,353,16,20525
10103,14,3,5,85,390,74,110,136,462,1172,6466,586,632,252,527,8463
10104,38,21,3,302,1243,172,199,161,4,1779,23716,2024,2128,954,34,28856
10201,180,6,3,1006,2332,757,600,113,23,3825,48412,9129,5704,745,139,64129
10202,154,7,0,527,2213,344,389,165,0,3111,47880,5286,3524,919,30,57639
10301,4,0,3,90,700,114,137,23,5,979,13947,1122,1068,107,34,16278
10302,4,4,0,200,1213,51,111,127,48,1550,20326,587,871,410,64,22258
10303,3,0,0,136,936,81,80,144,3,1244,15884,791,594,347,16,17632
10304,25,4,0,147,889,103,81,84,9,1166,18283,1170,1023,263,21,20760
10401,14,12,3,140,732,51,86,293,3,1165,17166,839,1256,1021,31,20313
10402,53,38,3,414,1079,185,279,124,0,1667,25272,3111,3007,1635,20,33045
10501,0,36,0,183,794,11,52,216,3,1076,9077,147,468,833,59,10584
10502,7,14,3,117,642,36,60,51,6,795,8356,114,397,336,70,9273
10503,94,12,0,288,1109,69,156,210,6,1550,22522,960,1736,517,29,25764
10601,9,6,0,215,1447,118,89,57,3,1714,27684,1426,1013,317,23,30463
10602,42,0,0,146,735,114,116,42,0,1007,20648,1549,1239,197,3,23636
10603,25,17,0,334,1073,222,198,98,0,1591,21441,2940,1370,726,21,26498
10604,4,0,3,106,595,43,70,59,3,770,10226,359,590,301,27,11503
10701,12,8,0,196,972,127,181,74,0,1354,22643,1892,1749,382,14,26680
10702,0,0,0,0,0,0,0,0,0,0,3,0,0,0,0,3
10703,122,6,0,279,903,163,146,47,3,1262,24991,3245,1895,514,10,30655
10704,193,5,0,408,1183,390,994,109,0,2676,29668,6661,10838,525,39,47731
10801,4,14,3,135,468,142,147,118,0,875,9381,1722,1435,607,14,13159
10802,12,12,0,137,826,86,105,155,0,1172,16621,944,1110,702,9,19386
10803,0,0,0,0,3,0,3,0,0,6,122,0,21,4,0,147
10804,87,63,0,544,919,215,378,109,5,1626,22578,3445,3300,1115,24,30462
10805,23,7,0,158,882,66,150,48,0,1146,18055,1149,1361,409,23,20997
10901,11,3,0,196,930,88,321,26,3,1368,18448,1153,3313,172,23,23109
10902,0,4,3,48,305,4,33,79,0,421,4524,57,218,341,10,5150
10903,20,14,0,202,848,55,111,75,0,1089,14762,517,1078,484,38,16879
11001,5,8,0,139,590,43,164,64,3,864,11734,583,1219,221,13,13770
11002,4,8,0,188,716,14,61,32,0,823,14041,249,676,326,18,15310
11003,6,6,0,113,631,46,113,67,3,860,8601,206,882,376,21,10086
11004,6,8,3,269,1291,144,227,155,5,1822,26510,1160,2037,426,54,30187
11101,66,3,0,326,1403,253,222,58,0,1936,37954,4003,2879,414,18,45268
11102,118,3,0,298,842,69,99,77,0,1087,23542,1245,1002,426,15,26230
11103,102,3,0,443,2084,498,907,82,8,3579,46858,7475,8953,312,91,63689
11201,128,19,0,347,1092,225,286,574,3,2180,22601,3503,3099,1811,38,31052
11202,39,7,0,232,1045,108,136,98,0,1387,23803,1212,1787,634,21,27457
11203,65,22,3,371,1107,435,456,188,7,2193,22703,6875,4619,1626,58,35881
11301,6,4,0,136,1018,74,185,73,0,1350,15285,783,1126,291,13,17498
11302,6,0,0,52,261,12,26,32,18,349,5256,83,314,96,18,5767
11303,62,7,3,307,1235,84,231,57,7,1614,29598,1126,2764,363,47,33898
11401,42,11,7,350,1835,176,169,112,6,2298,33192,1970,1623,824,59,37668
11402,22,4,0,167,701,83,28,20,3,835,15626,1244,318,135,20,17343
11501,140,0,9,614,814,216,171,0,0,1201,34988,5481,2140,6,34,42649
11502,12,3,3,123,285,11,20,9,0,325,7566,311,239,147,12,8275
11503,3,3,0,55,528,5,3,12,0,548,7808,32,50,105,12,8007
11504,0,3,0,30,286,28,23,11,0,348,7834,253,108,84,3,8282
11601,26,0,0,234,1541,278,289,5,4,2117,34630,4759,3006,67,60,42522
11602,0,0,0,87,615,110,13,44,0,782,19565,2841,248,337,7,22998
11603,9,0,0,186,1434,242,221,3,0,1900,25961,3726,2013,24,3,31727
11701,39,0,0,84,320,128,599,8,0,1055,5785,2153,6833,78,34,14883
11702,23,3,0,93,451,406,727,43,0,1627,7466,5529,7384,294,34,20707
11703,296,0,21,453,325,1752,9059,549,67,11752,3721,18528,63770,841,585,87445
11801,244,0,0,344,856,1029,4442,68,5,6400,10714,11082,31122,287,119,53324
11802,176,3,3,303,871,494,2905,30,4,4304,15153,7782,28062,230,64,51291
11901,92,7,0,358,1975,593,969,38,5,3580,35115,8853,8316,232,35,52551
11902,88,0,0,252,1400,376,1578,62,7,3423,22819,4546,14814,250,169,42598
11903,89,0,3,298,993,279,906,18,3,2199,24357,4885,12695,188,32,42157
11904,104,3,0,240,1241,290,1623,82,5,3241,22289,5133,17774,404,71,45671
12001,57,0,0,148,594,206,1199,36,4,2039,12954,3522,12439,168,63,29146
12002,36,0,0,89,335,451,593,46,3,1428,7804,8204,6314,295,21,22638
12003,145,0,4,327,1288,358,2144,53,5,3848,22638,5229,22952,369,83,51271
12101,236,3,3,345,645,130,1187,13,3,1978,18722,2743,17473,102,48,39088
12102,97,3,3,218,475,64,412,45,3,999,18924,1813,6647,103,24,27511
12103,171,0,3,353,898,107,445,4,3,1457,29178,1584,6191,30,52,37035
12104,150,4,0,224,472,377,2824,23,8,3704,8567,5867,27564,140,108,42246
12201,46,0,0,80,251,113,786,37,0,1187,6336,1893,7925,83,18,16255
12202,100,3,0,264,622,142,234,36,0,1034,15149,2239,2983,207,11,20589
12203,365,3,3,708,1017,205,1277,24,3,2526,31358,3234,17656,149,42,52439
12301,12,3,0,140,458,64,35,4,0,561,15544,1028,291,67,24,16954
12302,116,3,3,355,1972,590,201,12,4,2779,39510,7695,1935,199,21,49360
12303,9,4,0,109,553,23,21,31,0,628,11436,418,225,130,3,12212
12401,25,0,3,294,1337,111,57,69,0,1574,27010,1506,624,109,17,29266
12402,0,0,0,0,0,0,0,0,0,0,3,0,0,0,0,3
12403,19,4,29,203,1409,287,380,66,34,2176,34740,4944,3757,269,98,43808
12404,12,5,0,89,448,103,59,38,0,648,9753,1854,769,124,6,12506
12405,5,0,0,60,756,132,85,3,0,976,14957,1737,812,24,0,17530
12501,38,0,0,139,771,213,931,21,0,1936,11611,2843,9112,77,27,23670
12502,75,3,0,177,522,177,259,0,3,961,14339,3612,2742,54,60,20807
12503,51,3,0,307,1910,376,968,30,11,3295,30896,5393,8306,174,83,44852
12504,265,3,0,479,936,368,1751,62,4,3121,20751,5887,19347,106,55,46146
12601,55,0,0,128,260,37,120,3,0,420,11263,1132,2513,32,3,14943
12602,211,3,3,415,955,273,920,18,3,2169,24108,6483,14280,167,28,45066
12701,3,3,3,136,1377,127,153,13,0,1670,20531,2079,855,126,16,23607
12702,36,0,0,346,2343,443,545,14,3,3348,40198,7322,6064,148,52,53784
12703,29,0,3,184,1254,459,1040,13,4,2770,22811,4609,6859,39,40,34358
12801,175,0,0,306,834,296,1038,27,0,2195,23171,5409,12165,208,12,40965
12802,81,0,0,233,702,192,403,32,0,1329,27986,3484,4990,168,3,36631
19797,0,0,0,0,0,0,0,0,0,0,0,0,0,0,0,0
20101,28,3,0,258,1531,175,257,32,3,1998,32313,2258,2884,157,12,37624
20102,8,6,0,99,566,13,15,16,0,610,10304,104,202,146,0,10756
20103,9,4,0,83,500,14,17,29,3,563,9320,174,286,258,7,10045
20201,17,7,0,186,1347,127,209,52,0,1735,29859,1543,2295,299,10,34006
20202,3,4,0,118,844,23,57,27,0,951,16345,224,527,236,13,17345
20203,3,0,0,51,253,8,3,46,0,310,4389,29,73,149,0,4640
20301,0,0,0,32,246,9,0,0,0,255,5668,43,17,32,6,5766
20302,140,18,0,602,2634,231,604,141,0,3610,57368,3712,6973,698,20,68771
20303,12,4,3,133,940,69,102,29,0,1140,21090,1051,1170,176,11,23498
20401,19,11,0,190,1127,56,74,111,5,1373,18116,609,738,581,18,20062
20402,9,3,0,176,610,64,82,31,0,787,16046,782,1070,252,3,18153
20403,42,6,6,224,914,87,146,56,3,1206,22281,1375,1890,343,27,25916
20501,5,3,0,112,674,62,36,33,0,805,14769,1006,553,195,3,16526
20502,5,8,0,143,715,43,103,81,4,946,15372,629,1120,582,14,17717
20503,9,11,0,209,1205,72,116,66,0,1459,21923,871,838,344,16,23992
20504,86,3,0,195,1385,79,310,29,3,1806,24991,1014,2732,309,6,29052
20505,8,3,0,158,757,62,57,41,0,917,14821,659,609,204,6,16299
20601,38,0,0,174,932,380,781,25,0,2118,18236,5881,8182,192,17,32508
20602,18,4,0,76,526,135,468,32,0,1161,11823,2763,5529,213,11,20339
20603,53,0,0,142,594,212,974,24,0,1804,13051,3634,8190,100,10,24985
20604,170,4,0,234,113,647,4600,150,4,5514,2135,7261,37076,235,47,46754
20605,126,0,0,201,425,545,2885,157,3,4015,6859,9126,29616,390,22,46013
20606,86,0,0,157,471,372,1594,11,0,2448,6971,4976,14725,78,23,26773
20607,66,10,0,204,378,997,1411,118,8,2912,7157,13688,12611,335,36,33827
20701,91,0,0,352,1343,426,1058,23,0,2850,37282,8671,13356,260,24,59593
20702,81,0,0,326,899,177,156,4,0,1236,24854,3974,2295,25,3,31151
20703,126,0,0,478,1001,348,439,15,3,1806,25908,5861,4020,51,15,35855
20801,81,0,0,257,1010,344,461,13,0,1828,23675,5828,5026,119,22,34670
20802,125,0,0,363,1268,530,1147,53,0,2998,30528,9504,14217,307,34,54590
20803,113,3,0,335,1226,507,626,33,0,2392,27818,7918,7295,409,10,43450
20804,72,3,0,128,340,132,348,11,3,834,8218,2385,4674,90,9,15376
20901,21,0,0,271,1416,215,314,12,3,1960,36209,4516,4143,64,9,44941
20902,36,0,0,209,1635,402,612,41,0,2690,23760,4396,5515,179,14,33864
20903,3,0,0,99,629,37,27,9,0,702,20010,591,378,72,9,21060
20904,48,0,0,306,2542,189,175,5,0,2911,49900,3432,2233,80,6,55651
21001,12,0,0,138,978,93,91,7,0,1169,17530,1634,1283,36,6,20489
21002,0,0,0,50,368,8,20,4,0,400,8828,128,229,49,3,9237
21003,21,3,0,137,1278,317,270,22,4,1891,19040,4017,2577,119,20,25773
21004,5,0,0,51,537,22,58,3,0,620,11952,340,803,16,0,13111
21005,8,3,0,242,2244,329,175,39,3,2790,35795,4303,1486,289,30,41903
21101,141,7,0,722,1484,281,123,19,0,1907,46226,4552,2121,216,10,53125
21102,0,0,0,70,224,39,5,6,0,274,7669,593,75,41,0,8378
21103,31,0,0,226,970,362,98,24,0,1454,30135,7004,1874,74,9,39096
21104,50,0,0,183,601,140,120,3,0,864,17104,2798,1673,19,8,21602
21105,70,4,3,425,2007,127,131,54,3,2322,47901,1889,1860,329,18,51997
21201,168,3,0,295,1073,96,49,18,0,1236,23846,1088,804,205,10,25953
21202,87,4,0,326,1686,127,171,23,0,2007,37445,1927,1673,126,11,41182
21203,20,0,0,247,1727,111,122,5,3,1968,38140,1767,1577,49,3,41536
21204,127,6,3,481,2520,376,955,116,4,3971,41302,5530,11316,781,33,58962
21205,247,3,0,533,1965,380,491,13,3,2852,46032,6472,5975,93,32,58604
21301,34,3,0,301,3843,292,561,41,0,4737,50702,2936,4740,145,15,58538
21302,13,5,0,133,1296,247,304,31,0,1878,23232,4025,3386,230,10,30883
21303,52,3,0,160,1238,327,967,26,7,2565,17388,4176,6762,159,37,28522
21304,19,3,0,319,1957,197,134,40,3,2331,37710,2618,1300,224,15,41867
21305,43,0,0,326,2701,208,207,45,0,3161,50914,3115,2437,191,9,56666
21401,320,4,0,575,2138,276,457,88,0,2959,40389,3428,4997,506,14,49334
21402,64,6,3,629,2607,424,261,51,3,3346,48021,5169,2671,616,25,56502
21501,13,11,0,212,1053,40,80,109,0,1282,22352,670,1075,387,6,24490
21502,27,9,0,173,988,125,183,131,0,1427,17071,1085,1603,617,14,20390
21503,0,10,0,130,772,40,71,127,0,1010,13417,353,817,446,19,15052
21601,51,0,0,123,629,30,110,17,0,786,12653,441,1069,217,11,14391
21602,15,5,4,111,575,45,80,42,0,742,9888,364,778,273,15,11318
21603,47,7,0,234,1122,68,208,84,0,1482,19517,778,1906,508,20,22729
21701,7,3,0,111,659,19,65,32,0,775,13572,369,675,209,6,14831
21702,65,11,5,367,1389,106,180,119,3,1797,29351,1355,2041,438,15,33200
29797,0,0,0,0,0,0,0,0,0,0,0,0,0,0,0,0
30101,4,10,0,216,673,131,54,20,0,878,21576,2168,812,215,6,24777
30102,36,0,0,455,944,192,44,23,0,1203,24365,2857,838,156,5,28221
30103,57,5,0,238,774,214,145,30,0,1163,19992,2764,1336,280,10,24382
30201,46,0,0,142,362,74,44,0,0,480,11724,1565,477,5,0,13771
30202,117,0,0,416,794,198,322,66,3,1383,20039,2648,3865,370,6,26928
30203,9,0,0,56,450,74,209,4,0,737,9434,1050,3505,23,6,14018
30204,66,0,0,181,756,183,116,25,3,1083,16455,2454,1432,231,21,20593
30301,4,0,0,71,522,99,56,7,0,684,13715,2682,998,124,6,17525
30302,60,0,0,133,684,197,740,13,0,1634,15048,3022,9287,49,20,27426
30303,64,3,0,189,693,175,175,61,0,1104,18463,2875,1631,576,8,23553
30304,58,0,0,96,591,97,190,3,3,884,11214,956,1556,16,9,13751
30305,5,0,0,97,648,174,54,70,0,946,15059,2078,497,91,3,17728
30306,17,0,0,142,561,151,22,9,0,743,13059,2303,196,99,6,15663
30401,21,0,0,55,246,43,11,0,0,300,10271,622,95,0,5,10993
30402,16,0,3,110,308,37,10,0,0,355,13660,738,126,6,3,14533
30403,62,0,0,99,391,95,466,4,3,959,9234,1885,6959,21,12,18111
30404,21,0,0,181,419,48,64,0,0,531,14705,1221,1307,9,0,17242
30501,118,4,0,142,407,155,2752,69,7,3390,5144,1367,20909,150,56,27626
30502,15,0,0,52,420,205,309,4,0,938,9026,2580,3760,36,6,15408
30503,76,0,0,177,626,143,1069,4,0,1842,15662,2822,13536,62,24,32106
30504,21,0,0,96,516,83,400,111,0,1110,13135,1396,6612,223,12,21378
30601,22,9,0,103,623,83,294,96,0,1096,13999,1358,3040,637,7,19041
30602,60,28,5,301,1604,397,1511,160,11,3683,24448,2873,9501,934,97,37853
30603,0,44,0,127,618,20,133,189,3,963,11006,216,1124,1446,24,13816
30604,6,20,0,65,283,87,86,85,0,541,3217,580,697,622,8,5124
30605,4,22,3,139,769,17,97,141,3,1027,13368,301,902,984,38,15593
30701,16,26,6,287,1093,29,113,189,10,1434,14942,329,814,961,83,17129
30702,12,9,0,152,944,23,66,74,6,1113,14130,164,458,342,32,15126
30703,7,3,3,148,594,20,41,49,3,707,13835,305,713,209,25,15087
30801,0,65,0,210,692,29,87,205,12,1025,8781,308,728,1356,52,11225
30802,12,21,3,200,1543,128,322,320,9,2322,23205,811,1840,1775,50,27681
30803,32,36,0,393,2282,121,346,242,7,2998,35607,1275,3153,1728,39,41802
30901,60,0,0,149,811,457,1194,54,0,2516,12026,4547,8761,292,18,25644
30902,33,12,4,144,542,239,689,121,4,1595,11523,3328,6225,702,31,21809
30903,109,16,0,234,647,539,680,52,5,1923,11487,7465,6392,558,51,25953
30904,0,4,0,48,249,0,7,28,0,284,6202,74,71,148,6,6501
30905,3,3,0,67,356,85,15,21,0,477,8727,1489,148,71,0,10435
30906,37,3,0,294,864,335,63,38,0,1300,16757,4323,541,566,3,22190
30907,60,15,0,249,1104,324,140,57,5,1630,25520,4980,1176,487,17,32180
30908,35,0,0,159,521,332,255,11,9,1128,10558,4355,1911,38,30,16892
30909,163,11,0,251,741,330,740,61,4,1876,11639,3738,6387,350,22,22136
30910,63,0,0,119,319,210,1608,43,22,2202,4649,2263,9701,168,62,16843
31001,9,3,3,338,1003,130,52,28,0,1213,18573,1731,537,346,9,21196
31002,4,11,0,175,1160,27,16,81,0,1284,19829,199,223,529,47,20827
31003,28,4,0,167,1495,111,131,28,3,1768,31124,1742,1381,197,20,34464
31004,3,0,0,69,916,98,36,11,3,1064,20126,1324,482,89,6,22027
31101,3,3,0,41,215,9,22,7,0,253,4103,164,265,93,0,4625
31102,6,0,0,62,670,167,98,11,0,946,11043,1963,783,34,5,13828
31103,3,3,0,129,1120,61,30,7,0,1218,22353,781,223,184,9,23550
31104,0,0,0,52,537,0,7,3,0,547,11442,41,86,20,6,11595
31105,7,3,0,88,715,123,18,24,0,880,16934,1697,189,183,8,19011
31106,33,3,0,148,1188,302,192,20,0,1702,21238,3760,1727,150,12,26887
31201,4,32,3,185,862,84,143,244,6,1339,10492,756,750,1594,48,13640
31202,24,26,0,404,1566,192,376,214,3,2351,34014,2042,3307,1607,61,41031
31203,20,25,3,79,316,35,200,168,0,719,4882,358,1472,805,19,7536
31301,10,9,0,174,554,53,88,33,0,728,10618,997,1124,580,6,13325
31302,23,3,0,175,1142,146,90,28,6,1412,18175,1403,949,168,13,20708
31303,0,3,0,38,207,3,3,16,0,229,3902,36,35,73,3,4049
31304,0,0,0,102,780,126,31,28,0,965,17917,1419,342,207,12,19897
31305,47,9,0,326,809,129,336,42,0,1316,16711,2309,4143,353,6,23522
31401,17,3,0,248,652,56,12,0,0,720,25336,1057,295,43,0,26731
31402,42,0,0,274,503,120,51,74,0,748,15562,1809,518,257,34,18180
31403,3,0,0,47,354,46,52,24,0,476,10905,1223,707,38,0,12873
31501,8,105,9,249,545,53,73,316,22,1009,7215,457,911,1527,110,10220
31502,6,70,9,197,1082,89,285,583,11,2050,8804,490,1364,2274,147,13079
31503,9,43,13,174,441,22,23,210,22,718,7185,147,300,1365,269,9266
31601,48,0,0,789,435,85,62,10,0,592,14165,1833,825,88,0,16911
31602,99,9,0,306,667,220,368,51,0,1306,19866,3473,4399,794,0,28532
31603,48,7,0,225,607,233,542,103,0,1485,11798,3755,6425,1348,28,23354
31604,43,15,0,204,833,45,102,91,0,1071,19496,550,1243,685,21,21995
31605,22,8,0,270,423,168,222,20,0,833,10834,2098,2115,405,5,15457
31606,13,13,0,196,754,57,21,80,0,912,16199,553,240,546,10,17548
31701,154,3,4,534,1971,173,484,78,3,2709,44160,2432,5778,415,42,52827
31801,11,21,0,167,807,24,99,160,6,1096,14497,338,974,1208,28,17045
31802,92,15,0,558,2987,365,1069,222,8,4651,51622,3712,8776,1456,63,65629
31901,23,18,0,515,1249,159,236,202,0,1846,28106,1971,2391,1674,10,34152
31902,10,15,0,172,958,13,76,270,29,1346,17246,135,889,985,63,19318
31903,15,17,4,138,840,22,108,140,0,1110,16480,364,822,832,22,18520
31904,18,16,0,420,687,61,167,111,3,1029,17841,966,1934,1262,14,22017
31905,29,19,0,128,788,23,103,124,3,1041,15444,208,943,764,16,17375
39797,0,0,0,0,0,0,0,0,0,0,0,0,0,0,0,0
40101,51,0,0,90,66,250,648,103,3,1070,1087,3121,5085,128,18,9439
40102,33,4,0,298,748,37,36,24,3,848,23669,679,479,133,14,24974
40103,201,0,0,360,399,141,252,0,0,792,11701,2313,3135,15,5,17169
40104,112,3,0,314,633,122,130,0,3,888,15286,2047,1916,12,8,19269
40105,144,0,0,393,336,245,255,15,0,851,8413,3661,3508,45,8,15635
40106,57,0,0,118,369,117,103,7,0,596,8009,1267,1622,73,6,10977
40107,99,0,0,299,340,178,196,4,0,718,9154,3049,2999,8,10,15220
40201,0,0,0,170,425,77,24,15,0,541,10917,903,265,91,9,12185
40202,31,3,3,170,1228,407,113,16,0,1764,24328,4584,1346,132,6,30396
40203,26,0,0,244,972,205,155,9,0,1341,19049,3175,2329,82,0,24635
40204,29,0,0,461,2020,309,309,13,0,2651,40912,4392,2893,147,16,48360
40205,70,0,0,738,998,126,64,0,0,1188,31440,2709,1111,3,8,35271
40301,191,0,4,321,290,157,549,9,0,1005,7597,2787,4434,62,10,14890
40302,69,0,0,392,970,379,253,4,0,1606,25813,6214,3362,23,5,35417
40303,140,3,0,515,627,90,154,7,3,881,19546,1719,2524,76,6,23871
40304,79,6,0,1030,2148,254,167,42,3,2614,56421,3513,2304,403,33,62674
40401,130,4,0,497,1431,426,415,14,0,2286,30769,6725,4995,121,10,42620
40402,88,3,0,248,883,274,316,11,3,1487,16365,4010,2984,108,33,23500
40403,128,0,0,410,709,204,427,12,3,1355,16178,3278,5646,67,14,25183
40501,25,4,3,185,486,17,23,8,0,534,12120,395,348,126,12,13001
40502,13,4,3,101,370,6,18,16,3,413,8540,167,171,179,15,9072
40503,16,7,0,100,421,55,31,44,3,554,10158,743,418,272,14,11605
40504,11,5,0,143,347,31,31,35,0,444,9670,351,206,343,3,10573
40601,23,14,7,207,906,246,126,242,3,1523,17895,3611,1152,793,63,23514
40602,5,36,22,174,738,79,95,192,23,1127,8997,638,578,781,166,11160
40701,9,7,0,472,867,82,55,35,0,1039,18117,914,569,287,9,19896
40702,34,10,4,426,833,66,105,40,4,1048,22482,994,1629,302,30,25437
40703,53,16,0,411,1446,141,116,195,23,1921,24683,1471,1020,703,77,27954
49797,0,0,0,0,0,0,0,0,0,0,0,0,0,0,0,0
50101,30,24,0,213,807,56,36,76,3,978,14317,1069,413,472,23,16294
50102,26,4,0,367,1678,215,114,200,0,2207,31239,2534,1275,635,32,35715
50103,0,7,3,104,346,5,24,50,0,425,8198,98,236,191,13,8736
50201,199,7,0,1000,1559,319,198,86,0,2162,27194,3428,1747,586,21,32976
50301,200,3,0,437,741,195,486,0,5,1427,17467,2467,4256,15,26,24231
50302,265,0,0,471,902,635,2368,217,0,4122,17331,7046,17809,348,47,42581
50401,55,0,0,249,1099,395,389,9,0,1892,22440,5166,3973,20,18,31617
50402,3,0,0,85,826,37,18,22,0,903,13764,542,160,36,3,14505
50403,8,7,3,172,1693,178,177,110,3,2161,32307,2108,1401,394,45,36255
50501,50,0,0,287,1598,162,225,25,3,2013,49636,2764,1921,207,12,54540
50502,247,3,0,768,2433,1599,1021,32,0,5085,44649,20915,8365,184,25,74138
50503,55,10,0,846,2319,239,116,42,0,2716,46955,3661,1020,347,3,51986
50601,12,0,0,209,1146,117,105,23,0,1391,20398,1372,1118,130,10,23028
50602,51,3,3,170,1199,490,572,14,0,2275,17474,5090,4676,73,30,27343
50603,266,0,0,545,1051,413,300,3,0,1767,25145,4306,3001,38,8,32498
50604,88,0,3,451,2022,135,167,5,0,2329,34330,1822,1480,161,18,37811
50605,19,3,0,252,907,67,20,13,0,1007,18496,805,237,139,4,19681
50606,0,3,0,28,255,6,0,3,0,264,5790,23,14,34,3,5864
50607,83,0,0,267,469,327,435,0,7,1238,8696,4773,3993,0,13,17475
50701,9,4,3,184,1207,206,157,48,0,1618,27636,2954,1564,160,9,32323
50702,12,0,3,114,459,232,296,105,0,1092,9282,2967,2122,309,12,14692
50703,3,0,0,65,734,54,64,5,0,857,9652,511,470,9,6,10648
50704,225,0,0,532,1153,299,239,3,0,1694,30419,4495,2764,9,28,37715
50705,38,7,0,230,1715,169,205,59,3,2151,33340,2113,1999,409,11,37872
50801,0,3,0,52,330,38,31,58,4,461,4997,424,265,311,18,6015
50802,0,51,9,99,268,53,24,343,5,693,2818,270,207,2927,81,6303
50803,3,19,5,102,1261,246,153,241,12,1913,11436,1283,913,902,128,14662
50804,16,180,38,335,763,122,88,735,42,1750,7693,845,651,4911,448,14548
50805,14,34,6,197,957,108,99,211,27,1402,17226,961,997,1470,155,20809
50806,15,58,19,256,1889,464,292,614,29,3288,11825,1984,1136,2435,279,17659
50901,42,10,0,274,868,77,64,90,3,1102,19497,1067,655,433,15,21667
50902,3,13,4,225,1278,42,47,64,8,1439,19695,433,449,602,64,21243
50903,11,4,0,94,316,12,16,54,3,401,7264,249,252,189,6,7960
59797,0,0,0,0,0,0,0,0,0,0,0,0,0,0,3,3
60101,3,0,0,22,296,9,35,0,0,340,5263,104,428,18,0,5813
60102,27,3,0,141,679,94,89,11,0,873,17471,1112,979,69,6,19637
60103,23,0,0,119,779,87,185,6,0,1057,17257,1393,2689,97,3,21439
60104,15,0,0,90,318,22,40,5,0,385,10474,514,797,50,3,11838
60105,87,3,3,258,524,142,384,50,3,1103,13858,2277,4302,191,42,20670
60106,0,0,0,27,267,11,10,3,0,291,5602,183,109,41,5,5940
60201,95,3,0,268,1054,185,208,44,4,1495,26395,2424,3013,200,25,32057
60202,3,3,0,74,375,19,11,15,0,420,8325,284,165,113,3,8890
60203,11,0,0,132,654,19,34,19,3,729,14128,254,444,161,10,14997
60301,0,0,0,44,208,5,5,10,0,228,4281,92,50,37,5,4465
60302,3,3,0,63,239,14,3,11,0,267,6846,112,55,133,0,7146
60303,3,3,0,28,152,3,3,10,0,168,2605,78,52,93,0,2828
60401,28,3,0,131,695,66,115,18,3,897,17051,873,1376,172,6,19478
60402,4,3,0,116,581,97,76,56,0,810,15221,1092,745,235,21,17314
60403,7,0,0,75,349,9,20,15,0,393,6919,64,302,82,0,7367
69797,0,0,0,0,0,0,0,0,0,0,0,0,0,0,0,0
70101,19,26,9,73,179,118,774,190,8,1269,2606,1451,4889,514,55,9515
70102,5,12,0,97,1109,415,458,113,4,2099,11891,2835,2994,802,61,18583
70103,6,21,0,66,733,35,14,251,0,1033,5404,248,97,1241,16,7006
70104,0,12,0,34,642,99,129,22,0,892,7373,1031,1121,60,11,9596
70201,19,57,6,203,593,226,274,361,17,1471,7480,1609,1740,1630,121,12580
70202,0,27,4,53,124,17,22,111,4,278,1134,80,132,426,41,1813
70203,8,56,11,145,219,4,33,219,13,488,2977,26,318,1115,101,4537
70204,15,0,8,81,80,15,65,4,8,172,2291,197,378,22,49,2937
70205,6,60,10,124,329,56,125,290,15,815,3708,303,433,1442,135,6021
79797,0,0,0,0,0,0,0,3,0,3,0,0,0,3,0,3
80101,79,0,0,270,886,316,339,0,4,1545,26424,5174,3058,5,18,34679
80102,0,0,0,4,8,0,0,3,0,11,186,0,3,10,0,199
80103,0,3,0,6,19,0,9,24,0,52,272,27,90,203,0,592
80104,0,0,0,38,310,178,64,8,0,560,11712,4080,662,32,3,16489
80105,26,11,0,158,418,185,713,53,0,1369,9706,2739,6696,122,15,19278
80106,46,0,0,86,180,55,379,3,0,617,5476,1038,3910,6,3,10433
80107,4,0,0,170,783,152,44,0,0,979,26672,3610,831,9,7,31129
80108,16,0,0,70,162,68,15,0,0,245,7292,1194,316,6,9,8817
80109,25,0,0,76,263,68,163,0,0,494,9028,1798,2592,0,3,13421
89797,0,0,0,0,0,0,0,0,0,0,0,0,0,0,0,0
90101,0,0,0,5,16,7,60,0,0,83,212,82,262,6,0,562
90102,0,0,0,21,8,0,0,0,0,8,148,0,0,6,0,154
90103,0,0,0,3,3,0,0,4,0,7,71,0,3,11,10,95
99797,0,0,0,0,0,0,0,0,0,0,0,0,0,0,3,3
