region_id,2011_Census_75_79_years_Not_Married_Males,2011_Census_75_79_years_Not_Married_Females,2011_Census_75_79_years_Total_Males,2011_Census_75_79_years_Total_Females,2011_Census_75_79_years_Total_Persons,2011_Census_80_84_years_Married_in_a_registered_marriage_Males,2011_Census_80_84_years_Married_in_a_registered_marriage_Females,2011_Census_80_84_years_Married_in_a_de_facto_marriage_Males,2011_Census_80_84_years_Married_in_a_de_facto_marriage_Females,2011_Census_80_84_years_Not_Married_Males,2011_Census_80_84_years_Not_Married_Females,2011_Census_80_84_years_Total_Males,2011_Census_80_84_years_Total_Females,2011_Census_80_84_years_Total_Persons,2011_Census_85_years_and_over_Married_in_a_registered_marriage_Males,2011_Census_85_years_and_over_Married_in_a_registered_marriage_Females,2011_Census_85_years_and_over_Married_in_a_de_facto_marriage_Males,2011_Census_85_years_and_over_Married_in_a_de_facto_marriage_Females,2011_Census_85_years_and_over_Not_Married_Males,2011_Census_85_years_and_over_Not_Married_Females,2011_Census_85_years_and_over_Total_Males,2011_Census_85_years_and_over_Total_Females,2011_Census_85_years_and_over_Total_Persons,2011_Census_Total_Married_in_a_registered_marriage_Males,2011_Census_Total_Married_in_a_registered_marriage_Females,2011_Census_Total_Married_in_a_de_facto_marriage_Males,2011_Census_Total_Married_in_a_de_facto_marriage_Females,2011_Census_Total_Not_Married_Males,2011_Census_Total_Not_Married_Females,2011_Census_Total_Total_Males,2011_Census_Total_Total_Females,2011_Census_Total_Total_Persons
10101,255,535,851,989,1840,403,227,11,8,203,525,617,760,1377,181,99,3,0,151,486,335,585,920,12335,12519,2309,2406,8467,9481,23111,24406,47517
10102,118,229,381,399,780,177,95,0,0,71,228,248,323,571,51,20,0,0,71,250,122,270,392,9573,9725,2123,2111,7271,7448,18967,19284,38251
10103,71,131,256,229,485,90,60,3,0,54,133,147,193,340,62,32,0,0,55,138,117,170,287,3158,3187,699,711,2426,2393,6283,6291,12574
10104,323,595,1264,1274,2538,586,370,16,9,278,604,880,983,1863,305,158,0,5,233,587,538,750,1288,12708,12870,2630,2734,8549,9757,23887,25361,49248
10201,566,1572,2225,2876,5101,1233,862,32,19,586,1674,1851,2555,4406,771,434,16,7,594,1816,1381,2257,3638,29280,29707,5149,5315,22114,27861,56543,62883,119426
10202,588,1387,2175,2620,4795,1077,702,22,18,570,1335,1669,2055,3724,584,281,5,8,482,1352,1071,1641,2712,25305,25670,5117,5309,20926,25957,51348,56936,108284
10301,115,281,429,556,985,227,124,4,0,102,291,333,415,748,94,43,3,0,69,286,166,329,495,7189,7310,1572,1619,5597,6252,14358,15181,29539
10302,277,461,886,941,1827,405,255,7,8,239,489,651,752,1403,204,112,0,0,147,495,351,607,958,9912,10022,1785,1847,7295,7649,18992,19518,38510
10303,191,343,623,643,1266,256,167,3,0,138,320,397,487,884,106,43,3,3,90,310,199,356,555,7651,7758,1620,1645,6032,6227,15303,15630,30933
10304,178,398,659,759,1418,280,170,6,4,119,390,405,564,969,133,74,3,3,105,360,241,437,678,9437,9629,1793,1860,6819,7989,18049,19478,37527
10401,240,429,852,892,1744,388,234,15,3,177,432,580,669,1249,184,80,7,3,133,432,324,515,839,8834,8936,1730,1808,6622,7564,17186,18308,35494
10402,269,612,1175,1309,2484,584,337,12,15,241,577,837,929,1766,318,151,4,0,241,668,563,819,1382,14133,14400,3003,3133,10884,13223,28020,30756,58776
10501,118,148,304,274,578,109,61,0,0,88,156,197,217,414,29,12,0,3,49,114,78,129,207,3512,3529,1160,1172,3934,3412,8606,8113,16719
10502,93,227,304,382,686,147,89,5,0,83,224,235,313,548,60,25,0,0,63,163,123,188,311,3251,3313,818,857,3156,3484,7225,7654,14879
10503,259,531,814,957,1771,401,240,12,0,200,451,613,691,1304,180,82,6,0,138,448,324,530,854,10991,11371,2305,2435,8410,10140,21706,23946,45652
10601,226,486,821,905,1726,324,220,6,5,189,524,519,749,1268,155,60,6,0,146,463,307,523,830,14331,14589,3144,3248,10987,11573,28462,29410,57872
10602,134,380,622,765,1387,292,168,11,6,107,441,410,615,1025,153,84,3,0,111,414,267,498,765,11899,12182,2273,2359,8075,9481,22247,24022,46269
10603,229,529,1053,1150,2203,518,310,15,4,182,484,715,798,1513,242,124,7,3,175,501,424,628,1052,12725,12965,2303,2358,8396,9743,23424,25066,48490
10604,79,194,295,359,654,126,79,0,0,79,175,205,254,459,68,22,3,0,48,174,119,196,315,5008,5073,1226,1250,3910,3782,10144,10105,20249
10701,247,617,1098,1245,2343,497,320,10,9,247,554,754,883,1637,218,91,10,7,175,471,403,569,972,13494,13662,1959,2003,10468,11518,25921,27183,53104
10702,0,0,0,0,0,0,0,0,0,0,0,0,0,0,0,0,0,0,0,0,0,0,0,3,0,0,0,0,0,3,0,3
10703,221,621,1030,1208,2238,534,298,11,6,212,626,757,930,1687,235,136,4,3,174,545,413,684,1097,16256,16536,2416,2514,10894,12750,29566,31800,61366
10704,364,926,1488,1807,3295,800,524,6,4,292,1012,1098,1540,2638,477,223,6,3,326,1042,809,1268,2077,21188,21496,3655,3786,19031,20637,43874,45919,89793
10801,209,313,714,753,1467,385,249,9,7,193,346,587,602,1189,191,103,6,3,138,355,335,461,796,5625,5725,969,996,3992,4776,10586,11497,22083
10802,243,424,795,791,1586,326,253,14,6,204,422,544,681,1225,234,105,8,8,179,431,421,544,965,7801,7886,1643,1727,6752,7592,16196,17205,33401
10803,4,0,7,3,10,4,3,0,0,0,0,4,3,7,0,0,0,0,0,3,0,3,3,61,64,12,13,35,36,108,113,221
10804,314,741,1472,1660,3132,789,506,22,12,268,795,1079,1313,2392,404,197,9,3,306,857,719,1057,1776,14078,14339,2403,2454,8842,11543,25323,28336,53659
10805,244,486,925,975,1900,459,273,15,5,192,481,666,759,1425,228,91,0,0,171,460,399,551,950,9508,9619,1722,1748,6658,8015,17888,19382,37270
10901,153,418,593,785,1378,339,194,3,4,164,417,506,615,1121,164,81,3,0,114,424,281,505,786,9826,10031,1896,1961,7838,9362,19560,21354,40914
10902,57,77,183,171,354,67,40,0,0,47,69,114,109,223,25,10,0,3,22,75,47,88,135,2276,2326,434,452,1636,1536,4346,4314,8660
10903,190,360,746,768,1514,384,236,10,4,185,353,579,593,1172,180,80,0,3,157,342,337,425,762,7851,7932,1340,1364,5224,5272,14415,14568,28983
11001,86,276,377,471,848,172,106,0,0,106,269,278,375,653,98,54,0,0,62,233,160,287,447,5955,6036,1189,1229,4491,5440,11635,12705,24340
11002,177,332,615,632,1247,252,135,3,7,111,372,366,514,880,109,48,4,0,91,336,204,384,588,6774,6862,1285,1324,4910,5467,12969,13653,26622
11003,98,159,281,274,555,91,62,0,3,49,150,140,215,355,50,21,0,3,46,133,96,157,253,4162,4194,1017,1047,3395,3321,8574,8562,17136
11004,271,606,1076,1155,2231,461,280,10,6,203,631,674,917,1591,223,91,5,3,182,628,410,722,1132,13430,13724,2577,2695,9805,11714,25812,28133,53945
11101,382,1025,1661,2025,3686,884,609,19,10,374,1059,1277,1678,2955,504,235,6,6,346,1045,856,1286,2142,22426,22873,3549,3652,16082,19123,42057,45648,87705
11102,257,536,1001,1090,2091,504,337,3,3,232,543,739,883,1622,281,158,4,3,206,536,491,697,1188,13092,13331,2290,2409,9358,10739,24740,26479,51219
11103,453,1260,1701,2239,3940,851,668,13,10,496,1394,1360,2072,3432,548,263,11,0,434,1429,993,1692,2685,24694,25107,5931,6147,25172,28212,55797,59466,115263
11201,242,608,950,1187,2137,544,360,10,9,263,669,817,1038,1855,342,148,10,5,245,706,597,859,1456,11994,12241,2976,3079,10359,12619,25329,27939,53268
11202,232,512,859,994,1853,437,261,8,3,169,563,614,827,1441,206,92,3,0,173,567,382,659,1041,11239,11393,2721,2813,10046,11562,24006,25768,49774
11203,424,931,1610,1923,3533,919,561,27,17,359,869,1305,1447,2752,473,240,11,5,361,929,845,1174,2019,14927,15265,2997,3157,11815,14537,29739,32959,62698
11301,161,328,599,646,1245,281,139,3,5,124,348,408,492,900,121,61,0,0,99,304,220,365,585,8343,8430,1350,1382,6057,6207,15750,16019,31769
11302,54,103,212,203,415,77,53,3,4,57,114,137,171,308,58,23,3,3,28,112,89,138,227,2580,2616,591,603,1911,1791,5082,5010,10092
11303,257,619,1018,1209,2227,496,302,7,3,247,682,750,987,1737,271,123,0,0,186,683,457,806,1263,15528,15792,2874,3013,11338,13215,29740,32020,61760
11401,441,881,1760,1883,3643,866,593,25,11,367,850,1258,1454,2712,449,185,9,3,327,801,785,989,1774,17077,17369,2982,3109,12005,14030,32064,34508,66572
11402,149,406,757,809,1566,363,208,8,0,115,367,486,575,1061,188,94,5,0,118,395,311,489,800,8637,8793,1326,1342,5098,6682,15061,16817,31878
11501,171,574,1079,1184,2263,582,334,4,6,157,645,743,985,1728,287,129,3,0,181,692,471,821,1292,30397,30998,1789,1844,16058,18975,48244,51817,100061
11502,50,116,282,254,536,144,81,0,0,66,148,210,229,439,84,40,3,3,52,171,139,214,353,5472,5563,470,494,3310,3538,9252,9595,18847
11503,43,85,188,189,377,83,43,3,0,29,65,115,108,223,45,17,0,3,27,92,72,112,184,4809,4890,714,724,3022,2885,8545,8499,17044
11504,37,81,144,155,299,58,35,3,4,21,73,82,112,194,30,11,3,3,19,77,52,91,143,5779,5878,534,540,3054,3112,9367,9530,18897
11601,305,890,1101,1416,2517,475,272,6,3,264,693,745,968,1713,215,115,6,3,172,605,393,723,1116,23964,24160,2620,2700,18865,20528,45449,47388,92837
11602,97,212,312,351,663,123,69,0,0,66,185,189,254,443,47,17,0,0,36,172,83,189,272,15434,15616,1557,1610,8694,9619,25685,26845,52530
11603,153,472,572,705,1277,194,113,3,3,126,334,323,450,773,99,26,0,0,57,266,156,292,448,16810,16896,2336,2414,15370,17892,34516,37202,71718
11701,124,307,444,523,967,216,113,3,0,104,317,323,430,753,91,40,0,0,88,296,179,336,515,6983,7063,1093,1034,6231,7119,14307,15216,29523
11702,145,286,460,521,981,192,111,3,3,107,224,302,338,640,99,37,0,0,74,199,173,236,409,6850,6893,2818,2849,8744,9755,18412,19497,37909
11703,510,676,977,1018,1995,311,159,9,3,319,594,639,756,1395,161,47,3,0,200,573,364,620,984,16067,16165,14466,10628,37981,35890,68514,62683,131197
11801,286,782,1035,1300,2335,582,363,27,12,255,851,864,1226,2090,451,198,20,5,328,1245,799,1448,2247,17339,17588,6276,5753,17037,22277,40652,45618,86270
11802,313,861,1199,1480,2679,659,411,0,3,314,962,973,1376,2349,399,156,3,3,326,996,728,1155,1883,19221,19445,4949,5007,20595,24668,44765,49120,93885
11901,422,1094,1651,2034,3685,947,563,7,6,421,1284,1375,1853,3228,511,237,7,3,423,1266,941,1506,2447,29917,30083,2092,2127,23683,27122,55692,59332,115024
11902,314,801,1447,1565,3012,740,405,4,4,280,760,1024,1169,2193,408,162,4,0,224,774,636,936,1572,24247,24392,1691,1700,19847,20319,45785,46411,92196
11903,306,861,1435,1712,3147,766,480,8,3,279,988,1053,1471,2524,500,215,3,5,317,1102,820,1322,2142,23405,23668,2157,2136,17365,20965,42927,46769,89696
11904,337,877,1518,1697,3215,776,406,5,0,317,845,1098,1251,2349,444,216,3,3,324,1112,771,1331,2102,23600,23769,2803,2720,18905,21158,45308,47647,92955
12001,160,492,788,974,1762,485,244,7,4,155,576,647,824,1471,251,97,3,3,147,598,401,698,1099,14356,14555,2382,2421,9868,12387,26606,29363,55969
12002,106,293,337,442,779,132,71,3,4,105,244,240,319,559,66,26,3,3,64,242,133,271,404,7951,8104,3128,3151,6640,9493,17719,20748,38467
12003,362,945,1436,1652,3088,738,387,6,8,315,907,1059,1302,2361,386,168,8,3,290,963,684,1134,1818,24108,24324,3682,3716,22415,25625,50205,53665,103870
12101,183,560,900,1102,2002,523,310,8,0,188,645,719,955,1674,333,159,7,0,224,860,564,1019,1583,19444,19778,2856,2721,12884,16747,35184,39246,74430
12102,144,433,671,820,1491,354,253,5,3,147,434,506,690,1196,236,114,3,0,156,495,395,609,1004,16084,16307,1662,1683,9702,11174,27448,29164,56612
12103,198,709,1455,1613,3068,889,647,16,0,239,862,1144,1509,2653,637,330,4,0,295,1106,936,1436,2372,24308,24927,1362,1330,12029,15968,37699,42225,79924
12104,177,592,706,952,1658,344,226,8,4,191,595,543,825,1368,265,120,8,3,190,790,463,913,1376,14375,14664,4478,4301,11806,16793,30659,35758,66417
12201,80,225,359,432,791,227,163,9,3,66,268,302,434,736,156,67,0,0,113,353,269,420,689,6994,7130,1874,1867,4933,5962,13801,14959,28760
12202,115,361,606,752,1358,358,230,10,8,141,402,509,640,1149,227,102,4,4,163,497,394,603,997,11547,11755,1678,1726,6661,7875,19886,21356,41242
12203,330,964,1528,1878,3406,866,583,12,5,322,1139,1200,1727,2927,541,268,8,3,444,1405,993,1676,2669,27475,27881,4472,4597,18099,21076,50046,53554,103600
12301,61,213,326,385,711,137,87,0,3,65,215,202,305,507,84,47,3,0,49,214,136,261,397,10413,10533,1526,1591,5736,6915,17675,19039,36714
12302,254,707,913,1117,2030,359,236,14,13,183,582,556,831,1387,176,81,8,0,137,474,321,555,876,25366,25616,3918,4035,21822,25427,51106,55078,106184
12303,66,166,312,330,642,131,76,6,0,52,166,189,242,431,71,37,3,0,44,163,118,200,318,7124,7234,1130,1175,4517,4826,12771,13235,26006
12401,195,591,800,1006,1806,352,211,10,3,168,513,530,727,1257,187,93,3,3,162,584,352,680,1032,13878,14110,2506,2702,9440,11984,25824,28796,54620
12402,0,0,0,0,0,0,0,0,0,0,0,0,0,0,0,0,0,0,0,0,0,0,0,3,0,0,0,0,3,3,3,6
12403,240,601,887,1025,1912,375,197,0,3,187,554,562,754,1316,182,100,6,4,149,547,337,651,988,22550,22832,4077,4226,16966,19685,43593,46743,90336
12404,69,207,260,327,587,114,90,3,3,84,201,201,294,495,70,34,0,0,66,193,136,227,363,5649,5750,1225,1265,5021,5889,11895,12904,24799
12405,91,270,311,414,725,97,71,3,0,89,207,189,278,467,66,24,0,3,62,204,128,231,359,8985,9068,1589,1623,8228,8885,18802,19576,38378
12501,125,274,510,506,1016,207,124,0,0,116,333,323,457,780,114,56,0,0,113,348,227,404,631,13757,13850,1039,980,12386,11634,27182,26464,53646
12502,168,409,728,803,1531,368,215,5,0,145,395,518,610,1128,165,80,0,0,122,387,287,467,754,12241,12369,991,1008,8454,9700,21686,23077,44763
12503,345,882,1269,1491,2760,624,364,9,3,309,950,942,1317,2259,333,152,7,3,270,859,610,1014,1624,24773,24919,1925,1939,21573,23243,48271,50101,98372
12504,248,674,1036,1205,2241,488,277,0,5,223,680,711,962,1673,241,119,3,0,211,798,455,917,1372,24467,24545,2419,2472,18422,19146,45308,46163,91471
12601,72,254,497,595,1092,323,188,3,3,76,304,402,495,897,148,72,0,3,122,400,270,475,745,9517,9687,605,621,5782,7079,15904,17387,33291
12602,311,854,1321,1595,2916,748,476,6,0,299,1030,1053,1506,2559,430,199,0,3,332,1110,762,1312,2074,23110,23340,2672,2667,17334,21402,43116,47409,90525
12701,136,377,527,588,1115,206,98,3,4,102,284,311,386,697,81,19,0,0,67,207,148,226,374,14978,15101,1248,1251,11613,12693,27839,29045,56884
12702,394,1165,1778,2063,3841,851,396,7,3,338,1057,1196,1456,2652,390,148,3,3,269,843,662,994,1656,32641,32807,2109,2123,29659,33195,64409,68125,132534
12703,199,574,759,940,1699,330,160,3,5,151,495,484,660,1144,142,65,3,3,123,386,268,454,722,19529,19713,1911,1982,14338,15851,35778,37546,73324
12801,300,837,1398,1740,3138,897,615,16,6,287,1083,1200,1704,2904,488,249,4,3,326,1100,818,1352,2170,20268,20635,3217,3264,14263,17369,37748,41268,79016
12802,185,528,885,1062,1947,501,321,9,4,191,611,701,936,1637,249,108,6,3,182,600,437,711,1148,22426,22706,2421,2482,13417,15435,38264,40623,78887
19797,0,0,0,0,0,0,0,0,0,0,0,0,0,0,0,0,0,0,0,0,0,0,0,0,0,0,0,0,0,0,0,0
20101,252,721,985,1285,2270,497,318,4,0,209,784,710,1102,1812,282,154,0,0,212,762,494,916,1410,15683,15930,3293,3394,13179,16832,32155,36156,68311
20102,101,173,333,346,679,155,73,4,3,72,180,231,256,487,70,37,0,0,56,167,126,204,330,4931,4964,1117,1154,3530,3792,9578,9910,19488
20103,141,182,422,377,799,172,111,3,0,109,223,284,334,618,80,31,0,0,79,212,159,243,402,4422,4453,814,838,3593,3625,8829,8916,17745
20201,244,597,1006,1155,2161,477,357,6,0,225,723,708,1080,1788,286,129,0,3,203,687,489,819,1308,14215,14492,2942,3064,11943,15136,29100,32692,61792
20202,135,345,533,622,1155,265,155,8,4,132,289,405,448,853,127,61,7,3,106,310,240,374,614,7940,8111,1685,1683,5603,6397,15228,16191,31419
20203,61,90,175,200,375,96,53,3,0,62,97,161,150,311,47,18,0,0,53,83,100,101,201,2191,2231,358,363,1620,1436,4169,4030,8199
20301,36,62,143,146,289,63,27,0,0,20,58,83,85,168,22,12,0,0,21,64,43,76,119,3475,3527,533,551,1800,1784,5808,5862,11670
20302,509,1351,1982,2541,4523,1150,704,9,6,483,1456,1642,2166,3808,577,318,12,3,445,1519,1034,1840,2874,30305,30666,5619,5752,24726,30329,60650,66747,127397
20303,161,383,787,916,1703,482,289,6,0,142,480,630,769,1399,270,139,3,3,142,508,415,650,1065,11786,11962,1937,2057,6641,8425,20364,22444,42808
20401,198,377,673,754,1427,325,171,4,3,181,380,510,554,1064,147,68,0,0,124,347,271,415,686,8943,9110,1786,1847,6502,6920,17231,17877,35108
20402,157,378,624,755,1379,357,235,3,6,157,439,517,680,1197,190,94,0,0,139,448,329,542,871,8336,8516,1413,1430,5827,6960,15576,16906,32482
20403,177,402,733,796,1529,349,223,4,3,150,431,503,657,1160,188,86,3,0,136,409,327,495,822,11594,11865,2359,2424,8144,9295,22097,23584,45681
20501,135,307,552,601,1153,260,150,3,3,95,306,358,459,817,110,44,0,0,93,315,203,359,562,8153,8279,1451,1512,5432,6379,15036,16170,31206
20502,192,385,766,775,1541,334,208,7,3,154,385,495,596,1091,181,87,4,0,150,354,335,441,776,7891,8014,1592,1666,5407,6054,14890,15734,30624
20503,221,478,925,998,1923,456,278,11,10,211,507,678,795,1473,222,108,0,3,180,483,402,594,996,10671,10742,2085,2143,7150,8096,19906,20981,40887
20504,227,504,836,952,1788,405,240,8,4,201,506,614,750,1364,198,82,0,3,158,469,356,554,910,12004,12362,2640,2782,10105,11831,24749,26975,51724
20505,137,289,516,549,1065,250,154,10,0,133,333,393,487,880,121,71,3,3,101,323,225,397,622,7309,7601,1398,1470,5179,5875,13886,14946,28832
20601,242,587,838,1054,1892,458,248,6,5,190,541,654,794,1448,231,98,0,0,201,521,432,619,1051,11781,11912,3733,3873,13929,16195,29443,31980,61423
20602,145,350,533,646,1179,270,136,3,0,136,312,409,448,857,135,54,3,0,121,348,259,402,661,7234,7325,2470,2742,7841,9490,17545,19557,37102
20603,147,464,503,740,1243,289,171,3,0,164,467,456,638,1094,202,115,0,0,153,522,355,637,992,10073,10160,2148,2135,9527,11658,21748,23953,45701
20604,147,231,369,374,743,140,65,8,0,108,224,256,289,545,73,38,3,3,65,213,141,254,395,8828,8919,5353,4852,20028,21862,34209,35633,69842
20605,247,435,626,693,1319,252,142,12,4,222,418,486,564,1050,155,63,7,0,162,431,324,494,818,10993,11114,6728,6122,16206,18901,33927,36137,70064
20606,160,383,550,664,1214,274,170,7,3,142,405,423,578,1001,204,83,7,3,121,458,332,544,876,7108,7249,3274,2813,9494,12099,19876,22161,42037
20607,179,425,530,703,1233,246,116,6,4,154,355,406,475,881,136,57,3,0,111,338,250,395,645,8498,8550,5115,4808,13849,16533,27462,29891,57353
20701,306,1009,1551,1904,3455,907,606,18,9,334,1287,1259,1902,3161,671,335,7,0,389,1595,1067,1930,2997,29736,30517,4081,3972,22375,28160,56192,62649,118841
20702,216,754,1545,1620,3165,787,423,11,3,202,684,1000,1110,2110,377,158,4,0,192,665,573,823,1396,19365,19650,1308,1287,11708,14484,32381,35421,67802
20703,229,829,1260,1619,2879,757,524,8,3,273,1020,1038,1547,2585,443,226,0,0,347,1089,790,1315,2105,17769,18008,2032,2033,14261,18166,34062,38207,72269
20801,226,640,985,1263,2248,662,435,16,5,219,830,897,1270,2167,442,253,11,3,337,1207,790,1463,2253,18021,18444,2325,2376,10888,14471,31234,35291,66525
20802,338,1005,1340,1857,3197,883,592,18,4,398,1208,1299,1804,3103,617,286,12,7,463,1603,1092,1896,2988,25704,25909,3941,3892,20305,24256,49950,54057,104007
20803,320,883,1262,1647,2909,685,456,11,11,285,999,981,1466,2447,438,221,9,3,350,1053,797,1277,2074,20222,20464,3662,3695,14925,18509,38809,42668,81477
20804,83,262,373,480,853,201,130,0,0,97,291,298,421,719,141,77,0,0,98,352,239,429,668,7152,7266,1073,1012,5681,7327,13906,15605,29511
20901,285,859,1315,1665,2980,743,483,10,3,269,947,1022,1433,2455,434,206,0,0,299,995,733,1201,1934,22566,22826,3326,3366,16886,20579,42778,46771,89549
20902,266,797,1182,1441,2623,601,357,3,3,295,891,899,1251,2150,347,163,3,3,282,769,632,935,1567,14738,14797,2493,2634,14772,16621,32003,34052,66055
20903,78,175,363,393,756,178,99,4,3,59,181,241,283,524,88,48,0,0,61,216,149,264,413,13239,13461,1757,1846,8068,8840,23064,24147,47211
20904,282,803,1479,1588,3067,611,316,6,4,223,633,840,953,1793,244,102,5,0,173,488,422,590,1012,33429,33673,4108,4153,22994,25081,60531,62907,123438
21001,140,505,906,1032,1938,510,279,6,4,155,479,671,762,1433,241,101,4,0,140,457,385,558,943,11640,11764,1120,1111,7780,9251,20540,22126,42666
21002,46,101,203,204,407,96,52,0,0,25,95,121,147,268,53,25,0,0,27,105,80,130,210,5443,5553,888,859,2896,3302,9227,9714,18941
21003,231,721,1068,1410,2478,663,420,4,0,241,776,908,1196,2104,366,142,0,3,238,731,604,876,1480,12175,12272,1613,1674,10785,11911,24573,25857,50430
21004,66,185,303,346,649,129,85,3,0,58,171,190,256,446,45,29,3,0,40,140,88,169,257,6835,6943,1280,1304,4891,5770,13006,14017,27023
21005,193,620,891,1059,1950,371,171,0,4,167,454,538,629,1167,129,42,7,0,97,310,233,352,585,24779,24907,2421,2434,19784,21020,46984,48361,95345
21101,289,857,1316,1605,2921,651,395,12,8,264,821,927,1224,2151,342,182,5,0,233,825,580,1007,1587,29995,30293,4058,4163,21164,24223,55217,58679,113896
21102,44,103,272,254,526,142,71,0,0,39,121,181,192,373,58,33,0,0,33,117,91,150,241,5651,5763,452,467,3194,3514,9297,9744,19041
21103,262,713,1104,1357,2461,528,353,11,0,240,786,779,1139,1918,305,156,3,0,224,735,532,891,1423,19305,19496,3229,3259,14448,17625,36982,40380,77362
21104,157,491,744,926,1670,404,244,6,0,132,469,542,713,1255,223,116,0,3,147,500,370,619,989,11845,11998,1217,1248,7666,9443,20728,22689,43417
21105,249,675,1204,1363,2567,608,378,11,0,254,730,873,1108,1981,283,143,0,3,247,672,530,818,1348,27168,27470,5232,5331,19254,21428,51654,54229,105883
21201,125,265,584,581,1165,258,166,6,5,117,297,381,468,849,128,54,0,3,105,263,233,320,553,13540,13692,3069,3171,8969,10021,25578,26884,52462
21202,165,599,947,1146,2093,458,269,5,8,183,561,646,838,1484,223,109,4,3,154,461,381,573,954,24493,24655,2972,3039,16807,18714,44272,46408,90680
21203,152,447,671,796,1467,294,175,11,3,160,361,465,539,1004,127,61,0,4,110,335,237,400,637,23880,24064,4074,4172,17031,17879,44985,46115,91100
21204,462,1280,1965,2317,4282,931,506,15,8,381,1225,1327,1739,3066,484,215,12,6,307,1049,803,1270,2073,32270,32416,2730,2764,29783,29462,64783,64642,129425
21205,408,1216,2352,2612,4964,1333,766,11,8,410,1268,1754,2042,3796,621,278,4,3,370,1250,995,1531,2526,32807,33254,2978,2975,25985,28068,61770,64297,126067
21301,319,955,1535,1734,3269,645,385,10,4,239,847,894,1236,2130,304,130,0,0,247,741,551,871,1422,32048,32240,3293,3291,29563,30197,64904,65728,130632
21302,242,655,901,1163,2064,425,252,4,0,227,605,656,857,1513,244,113,6,0,220,577,470,690,1160,14368,14545,2677,2716,12190,13220,29235,30481,59716
21303,188,441,532,726,1258,316,183,7,0,172,443,495,626,1121,173,78,3,0,164,458,340,536,876,10643,10707,3164,3049,12755,12852,26562,26608,53170
21304,158,456,605,767,1372,241,147,4,6,123,388,368,541,909,110,56,0,0,87,345,197,401,598,23035,23272,3916,3967,15520,17388,42471,44627,87098
21305,183,494,787,941,1728,340,177,3,3,139,509,482,689,1171,141,74,6,0,127,419,274,493,767,30471,30883,5409,5396,21486,23467,57366,59746,117112
21401,328,849,1185,1540,2725,597,362,16,7,292,830,905,1199,2104,317,168,7,3,263,776,587,947,1534,20758,20983,5112,5191,19072,22154,44942,48328,93270
21402,518,1211,2304,2573,4877,1258,827,31,18,511,1237,1800,2082,3882,711,342,6,3,478,1367,1195,1712,2907,27045,27412,4782,4943,17502,22098,49329,54453,103782
21501,241,570,947,1039,1986,461,324,10,4,253,634,724,962,1686,251,128,3,0,193,619,447,747,1194,11250,11382,1807,1841,7916,8623,20973,21846,42819
21502,156,403,621,753,1374,338,200,5,4,142,422,485,626,1111,172,88,0,3,129,405,301,496,797,8713,8937,1658,1754,6873,7990,17244,18681,35925
21503,150,333,572,655,1227,302,190,5,3,141,332,448,525,973,167,80,6,3,119,360,292,443,735,7016,7058,1094,1118,5157,5186,13267,13362,26629
21601,147,309,536,602,1138,250,165,3,3,106,312,359,480,839,130,64,3,0,105,303,238,367,605,6828,6935,1170,1200,4662,5245,12660,13380,26040
21602,104,242,475,528,1003,246,163,0,3,107,232,353,398,751,132,54,4,3,90,240,226,297,523,5361,5418,892,917,3620,3839,9873,10174,20047
21603,181,413,652,765,1417,329,206,3,7,136,391,468,604,1072,178,94,4,3,121,396,303,493,796,10550,10667,1880,1928,7996,9041,20426,21636,42062
21701,141,303,493,561,1054,233,154,4,4,137,343,374,501,875,126,59,0,0,110,332,236,391,627,6784,6867,1161,1199,4739,5167,12684,13233,25917
21702,289,711,1072,1321,2393,527,322,6,5,256,710,789,1037,1826,269,137,3,3,219,727,491,867,1358,15236,15365,2869,2930,11159,12560,29264,30855,60119
29797,0,0,0,0,0,0,0,0,0,0,0,0,0,0,0,0,0,0,0,0,0,0,0,0,0,0,0,0,0,0,0,0
30101,139,326,564,621,1185,293,175,4,6,117,349,414,530,944,148,82,5,3,120,346,273,431,704,13313,13629,2473,2548,9247,10591,25033,26768,51801
30102,198,540,913,1072,1985,490,330,15,6,212,591,717,927,1644,306,128,7,0,201,585,514,713,1227,15146,15557,2470,2564,9104,11206,26720,29327,56047
30103,165,429,590,758,1348,260,188,3,3,148,429,411,620,1031,172,82,3,3,152,466,327,551,878,11510,11747,2553,2651,8468,10222,22531,24620,47151
30201,77,252,428,509,937,231,135,3,0,72,252,306,387,693,108,50,0,0,69,294,177,344,521,7732,7907,1148,1183,4753,5819,13633,14909,28542
30202,194,551,811,1065,1876,474,299,4,6,195,688,673,993,1666,276,143,5,0,201,805,482,948,1430,11024,11237,2645,2705,9862,12407,23531,26349,49880
30203,93,220,296,354,650,136,101,4,0,81,228,221,329,550,103,57,3,0,91,256,197,313,510,5366,5468,1592,1589,5956,6241,12914,13298,26212
30204,137,429,517,756,1273,281,174,4,3,139,452,424,629,1053,137,61,3,5,120,359,260,425,685,9014,9206,2051,2160,7423,9150,18488,20516,39004
30301,104,305,441,588,1029,263,183,3,3,105,401,371,587,958,145,63,0,3,103,399,248,465,713,8729,8857,1565,1616,6440,8203,16734,18676,35410
30302,182,415,450,624,1074,238,157,4,0,153,462,395,619,1014,148,86,0,3,150,472,298,561,859,9340,9491,3111,3174,11736,12841,24187,25506,49693
30303,153,456,707,862,1569,350,206,3,3,118,448,471,657,1128,193,87,4,4,119,452,316,543,859,12182,12367,1876,1938,9980,11604,24038,25909,49947
30304,94,274,382,494,876,202,153,0,3,62,284,264,440,704,141,73,0,0,95,336,236,409,645,6038,6150,1232,1261,5898,6417,13168,13828,26996
30305,60,166,299,327,626,137,76,0,0,55,180,192,256,448,67,24,3,0,46,138,116,162,278,10270,10448,1532,1594,7326,7952,19128,19994,39122
30306,70,208,329,393,722,178,110,5,0,55,218,238,328,566,96,44,0,0,64,228,160,272,432,8720,8826,1052,1050,7696,8165,17468,18041,35509
30401,55,144,228,265,493,133,73,0,0,37,136,170,209,379,54,34,0,0,37,142,91,176,267,6799,6918,825,870,3767,4528,11391,12316,23707
30402,50,183,420,439,859,244,142,4,0,59,181,307,323,630,115,56,3,0,58,223,176,279,455,9488,9779,884,894,4898,5870,15270,16543,31813
30403,69,228,310,416,726,217,159,0,0,74,293,291,452,743,134,66,0,0,90,353,224,419,643,6996,7175,1502,1494,8244,9333,16742,18002,34744
30404,71,283,387,528,915,215,153,3,0,89,315,307,468,775,139,84,3,0,80,379,222,463,685,8617,8859,1646,1717,6031,7495,16294,18071,34365
30501,109,191,303,321,624,118,60,4,0,105,210,227,270,497,76,21,0,3,81,252,157,276,433,6027,6110,3437,3257,12140,11484,21604,20851,42455
30502,77,151,211,248,459,93,58,0,0,63,184,156,242,398,46,28,3,0,66,197,115,225,340,5636,5788,1948,1938,5978,6539,13562,14265,27827
30503,183,395,489,623,1112,241,177,3,3,133,395,377,575,952,130,62,0,3,140,531,270,596,866,10779,11041,3653,3517,13120,14499,27552,29057,56609
30504,84,251,268,392,660,131,92,8,4,83,246,222,342,564,92,41,3,0,78,318,173,359,532,7791,7964,2396,2423,8883,10544,19070,20931,40001
30601,76,136,301,280,581,95,54,3,0,39,136,137,190,327,61,30,3,0,47,103,111,133,244,7742,8231,2387,2488,5504,6558,15633,17277,32910
30602,226,403,691,705,1396,268,164,9,3,174,410,451,577,1028,138,54,3,0,139,465,280,519,799,12535,13116,4232,4437,13602,15273,30369,32826,63195
30603,126,203,449,422,871,198,88,5,0,97,197,300,285,585,86,38,0,0,66,173,152,211,363,5532,5676,1366,1412,5022,4426,11920,11514,23434
30604,41,47,103,78,181,31,9,3,3,24,37,58,49,107,9,5,0,0,14,25,23,30,53,1523,1572,634,637,1489,1439,3646,3648,7294
30605,179,277,602,543,1145,247,132,3,3,101,272,351,407,758,123,51,6,0,95,244,224,295,519,6425,6728,1489,1580,4939,5583,12853,13891,26744
30701,153,220,471,429,900,188,90,3,6,123,218,314,314,628,69,30,0,0,87,201,156,231,387,7424,7592,1634,1697,5029,4661,14087,13950,28037
30702,149,237,539,485,1024,204,128,3,0,110,218,317,346,663,109,45,0,0,92,194,201,239,440,7370,7551,1293,1362,4823,4624,13486,13537,27023
30703,141,296,580,570,1150,229,137,11,5,108,300,348,442,790,123,49,3,0,91,300,217,349,566,7231,7426,1264,1332,4598,5447,13093,14205,27298
30801,46,54,118,111,229,39,17,0,0,28,45,67,62,129,12,10,0,0,22,38,34,48,82,4701,4858,1319,1357,3504,2635,9524,8850,18374
30802,143,267,527,504,1031,197,110,3,0,104,243,304,353,657,85,42,0,3,72,180,157,225,382,12578,12896,3182,3293,9184,7360,24944,23549,48493
30803,363,729,1183,1349,2532,536,328,11,0,273,642,820,970,1790,217,86,3,5,191,646,411,737,1148,17304,18465,4063,4486,13844,15488,35211,38439,73650
30901,196,484,770,934,1704,428,296,12,6,172,561,612,863,1475,266,121,10,3,195,559,471,683,1154,9069,9255,2565,2587,8883,10865,20517,22707,43224
30902,205,420,695,811,1506,346,251,10,3,175,461,531,715,1246,223,112,9,3,197,449,429,564,993,8073,8242,1992,2058,7708,9163,17773,19463,37236
30903,206,543,854,1013,1867,440,309,14,7,192,531,646,847,1493,269,125,6,0,199,506,474,631,1105,10005,10182,2501,2549,8562,11008,21068,23739,44807
30904,38,84,183,187,370,95,45,5,0,25,65,125,110,235,41,20,0,0,33,66,74,86,160,3438,3511,631,664,1955,2229,6024,6404,12428
30905,56,109,241,235,476,94,45,0,0,44,76,138,121,259,47,19,0,0,25,81,72,100,172,5941,6096,1061,1086,3450,4217,10452,11399,21851
30906,152,282,539,537,1076,229,130,6,3,122,284,357,417,774,131,62,3,3,93,334,227,399,626,11081,11360,2449,2581,8043,9440,21573,23381,44954
30907,140,275,645,587,1232,268,150,9,5,82,258,359,413,772,135,65,3,4,87,235,225,304,529,17263,17772,4138,4328,10193,11474,31594,33574,65168
30908,93,272,478,517,995,233,147,12,3,60,254,305,404,709,122,65,10,0,71,231,203,296,499,7739,7929,1640,1645,5767,7889,15146,17463,32609
30909,135,381,501,631,1132,251,195,6,3,123,409,380,607,987,197,100,8,0,116,410,321,510,831,8061,8206,2168,2192,8861,10674,19090,21072,40162
30910,112,225,427,421,848,211,138,8,3,94,236,313,377,690,135,70,8,0,106,276,249,346,595,5229,5314,1614,1577,6251,6151,13094,13042,26136
31001,118,376,450,631,1081,238,142,3,0,107,342,348,484,832,120,56,0,3,103,353,223,412,635,9950,10095,2027,2073,8801,10603,20778,22771,43549
31002,190,287,660,570,1230,246,123,4,0,118,264,368,387,755,105,47,0,0,118,275,223,322,545,10400,10704,2065,2165,7097,7467,19562,20336,39898
31003,222,561,833,1041,1874,389,225,4,3,193,548,586,776,1362,188,92,5,0,150,504,343,596,939,15313,15643,3662,3830,13257,14862,32232,34335,66567
31004,69,183,251,310,561,90,50,7,0,40,127,137,177,314,46,21,0,0,35,123,81,144,225,10314,10553,3108,3218,8603,9362,22025,23133,45158
31101,46,81,169,160,329,73,38,0,0,20,79,93,117,210,28,17,0,0,34,68,62,85,147,2150,2185,435,456,1612,1780,4197,4421,8618
31102,100,196,359,368,727,166,90,4,5,78,177,248,272,520,70,25,3,0,62,151,135,176,311,5843,5935,1634,1687,5390,6127,12867,13749,26616
31103,105,236,414,463,877,186,86,4,0,92,197,282,283,565,76,43,0,0,50,156,126,199,325,11812,12037,3089,3199,9909,10669,24810,25905,50715
31104,45,80,178,172,350,64,33,0,0,39,45,103,78,181,27,11,0,0,26,72,53,83,136,7276,7495,1464,1525,4073,3922,12813,12942,25755
31105,87,289,385,501,886,162,114,5,8,68,246,235,368,603,98,48,3,0,77,200,178,248,426,9622,9792,2173,2281,7409,8530,19204,20603,39807
31106,136,352,456,528,984,144,90,0,0,116,255,260,345,605,83,47,4,0,90,291,177,338,515,11770,11933,2726,2813,11661,12798,26157,27544,53701
31201,75,124,208,205,413,63,46,0,3,63,95,126,144,270,36,11,0,0,45,69,81,80,161,5546,5680,1567,1641,4200,3039,11313,10360,21673
31202,257,553,909,1044,1953,413,238,9,3,183,524,605,765,1370,192,97,3,0,128,437,323,534,857,18616,20177,4685,5164,14396,13449,37697,38790,76487
31203,25,61,125,135,260,55,26,3,0,31,46,89,72,161,16,13,0,0,19,53,35,66,101,2655,2832,905,981,2234,1920,5794,5733,11527
31301,151,343,716,775,1491,367,212,12,4,169,320,548,536,1084,169,90,4,3,147,268,320,361,681,6296,6397,992,1049,3846,4747,11134,12193,23327
31302,148,272,517,514,1031,218,124,6,3,114,273,338,400,738,116,47,9,0,98,268,223,315,538,8958,9216,2525,2640,7617,9226,19100,21082,40182
31303,35,45,123,107,230,43,12,0,0,29,51,72,63,135,20,11,0,0,18,53,38,64,102,2058,2105,400,422,1312,1326,3770,3853,7623
31304,112,282,453,532,985,233,133,5,5,94,231,332,369,701,102,43,3,0,79,178,184,221,405,10540,10860,2141,2220,7038,8176,19719,21256,40975
31305,247,568,798,999,1797,376,212,3,6,203,608,582,826,1408,192,91,3,4,205,604,400,699,1099,9311,9505,2112,2184,8311,10388,19734,22077,41811
31401,93,243,453,461,914,177,110,4,3,83,234,264,347,611,91,40,0,0,73,241,164,281,445,17064,17525,2368,2466,8833,9735,28265,29726,57991
31402,66,213,316,404,720,162,102,3,0,59,195,224,297,521,95,51,0,0,74,233,169,284,453,9436,9697,2251,2346,5470,6860,17157,18903,36060
31403,54,151,237,277,514,114,84,5,0,39,150,158,234,392,54,21,0,4,34,146,88,171,259,6231,6374,1424,1483,4962,5583,12617,13440,26057
31501,54,69,134,111,245,53,21,0,3,46,54,99,78,177,18,4,0,0,35,38,53,42,95,2754,2815,2032,2060,4192,3753,8978,8628,17606
31502,72,78,172,139,311,44,19,3,0,48,73,95,92,187,13,4,0,0,24,59,37,63,100,3875,3918,1818,1874,4355,3510,10048,9302,19350
31503,93,126,217,213,430,76,44,0,0,65,126,141,170,311,43,16,0,0,40,95,83,111,194,3121,3224,864,939,2429,2374,6414,6537,12951
31601,92,353,631,776,1407,384,257,8,4,121,405,513,666,1179,273,126,3,4,131,439,407,569,976,8924,9266,1396,1451,4816,7045,15136,17762,32898
31602,229,562,1235,1323,2558,637,412,19,8,238,675,894,1095,1989,372,168,6,3,223,638,601,809,1410,13433,13882,2484,2673,8161,10757,24078,27312,51390
31603,173,380,671,736,1407,306,183,3,6,134,361,443,550,993,182,100,0,3,133,371,315,474,789,8116,8375,2316,2436,7452,9245,17884,20056,37940
31604,170,294,704,671,1375,323,191,5,3,138,320,466,514,980,165,69,0,0,105,312,270,381,651,10748,11157,2158,2277,6976,8150,19882,21584,41466
31605,110,301,539,589,1128,276,162,6,8,92,272,374,442,816,162,82,3,3,101,293,266,378,644,6505,6729,1429,1461,4095,5651,12029,13841,25870
31606,124,200,628,529,1157,268,145,0,3,101,206,369,354,723,134,66,0,0,103,213,237,279,516,8947,9307,1726,1826,5255,6107,15928,17240,33168
31701,364,1057,1503,1938,3441,737,469,12,10,298,1048,1047,1527,2574,436,198,7,4,284,1002,727,1204,1931,24639,25495,4191,4371,16802,21641,45632,51507,97139
31801,144,354,611,669,1280,252,154,0,4,129,346,381,504,885,145,37,3,0,83,314,231,351,582,7614,7852,1506,1597,5569,5714,14689,15163,29852
31802,378,834,1197,1438,2635,548,321,9,4,303,756,860,1081,1941,251,128,3,0,218,692,472,820,1292,25975,27687,7781,8526,23681,25436,57437,61649,119086
31901,352,662,1326,1397,2723,632,355,17,8,287,611,936,974,1910,312,145,5,3,241,571,558,719,1277,15535,16133,2779,2968,10624,12682,28938,31783,60721
31902,207,304,692,621,1313,264,144,8,4,151,328,423,476,899,141,54,3,3,112,264,256,321,577,8578,8823,1697,1782,6198,6330,16473,16935,33408
31903,178,287,656,608,1264,294,156,8,3,123,265,425,424,849,126,57,4,0,101,283,231,340,571,8399,8664,1582,1714,5763,6297,15744,16675,32419
31904,251,444,1016,1000,2016,450,267,22,10,149,399,621,676,1297,208,99,4,6,163,348,375,453,828,9789,10134,1814,1965,6220,8265,17823,20364,38187
31905,192,295,638,615,1253,254,142,12,5,137,296,403,443,846,127,64,3,7,132,264,262,335,597,7629,7912,1530,1665,5475,5946,14634,15523,30157
39797,0,0,0,0,0,0,0,0,0,0,0,0,0,0,0,0,0,0,0,0,0,0,0,0,0,0,0,0,0,0,0,0
40101,43,82,102,135,237,56,38,4,0,39,86,99,124,223,48,13,0,0,38,102,86,115,201,1927,1939,847,792,4222,4166,6996,6897,13893
40102,111,315,601,654,1255,303,171,4,0,107,333,414,504,918,153,71,3,0,101,347,257,418,675,13666,13970,2460,2555,7803,8867,23929,25392,49321
40103,107,384,583,714,1297,372,248,8,3,129,501,509,752,1261,223,117,7,3,144,642,374,762,1136,8343,8512,972,972,5570,7683,14885,17167,32052
40104,169,477,830,934,1764,445,264,8,0,126,466,579,730,1309,194,79,0,0,142,433,336,512,848,9835,9968,1104,1119,7003,8695,17942,19782,37724
40105,113,366,423,620,1043,275,184,4,3,116,376,395,563,958,172,73,0,0,125,486,297,559,856,5642,5727,1170,1206,5804,7339,12616,14272,26888
40106,74,203,274,362,636,176,107,3,0,73,235,252,342,594,103,48,0,0,82,279,185,327,512,4869,4962,777,797,4356,4772,10002,10531,20533
40107,91,265,336,452,788,201,142,3,0,82,327,286,469,755,138,79,0,0,115,396,253,475,728,6249,6391,1270,1310,5157,6818,12676,14519,27195
40201,99,211,392,426,818,211,141,0,0,63,203,274,344,618,98,38,3,3,81,198,182,239,421,5965,6089,1118,1177,4124,4813,11207,12079,23286
40202,211,482,814,941,1755,372,218,10,5,178,465,560,688,1248,134,62,7,5,145,350,286,417,703,11717,11910,3460,3565,12426,13573,27603,29048,56651
40203,162,465,665,885,1550,400,249,8,3,169,516,577,768,1345,210,87,0,0,193,533,403,620,1023,10072,10184,1841,1883,10344,11150,22257,23217,45474
40204,284,697,1213,1327,2540,492,280,14,8,222,625,728,913,1641,217,97,3,7,193,490,413,594,1007,21822,22167,4644,4756,19642,20926,46108,47849,93957
40205,184,544,1020,1161,2181,523,328,13,4,157,529,693,861,1554,265,115,3,6,140,574,408,695,1103,18779,19063,2874,2959,12088,14031,33741,36053,69794
40301,111,344,424,625,1049,270,205,7,4,116,464,393,673,1066,209,124,0,3,160,652,369,779,1148,5754,5886,1088,1127,4896,6389,11738,13402,25140
40302,225,759,1025,1383,2408,677,458,6,10,241,857,924,1325,2249,351,186,9,4,300,916,660,1106,1766,15015,15273,2915,3000,12910,15900,30840,34173,65013
40303,155,437,796,940,1736,488,323,7,4,164,538,659,865,1524,329,171,4,3,210,722,543,896,1439,12309,12566,1667,1715,8177,9921,22153,24202,46355
40304,326,875,1579,1778,3357,878,542,18,7,309,887,1205,1436,2641,434,223,10,0,273,845,717,1068,1785,29451,30045,6363,6594,21879,24808,57693,61447,119140
40401,318,955,1493,1815,3308,874,515,9,8,375,1047,1258,1570,2828,489,236,8,3,369,1185,866,1424,2290,18365,18559,3119,3227,16720,19083,38204,40869,79073
40402,184,458,608,800,1408,325,204,13,3,174,515,512,722,1234,202,90,4,3,191,521,397,614,1011,8743,8877,2079,2238,10010,10791,20832,21906,42738
40403,176,522,842,1013,1855,453,306,11,5,206,647,670,958,1628,316,142,4,3,245,674,565,819,1384,9738,9878,1970,2072,10206,11317,21914,23267,45181
40501,82,204,426,425,851,191,132,3,0,70,215,264,347,611,118,59,0,0,69,264,187,323,510,6779,6909,1182,1232,4022,4123,11983,12264,24247
40502,97,156,346,325,671,138,85,3,0,80,164,221,249,470,78,36,0,0,68,213,146,249,395,4218,4299,775,795,2899,2759,7892,7853,15745
40503,125,235,431,454,885,188,108,0,3,113,267,301,378,679,100,46,0,0,91,247,191,293,484,4917,5061,932,988,3804,4016,9653,10065,19718
40504,131,223,468,512,980,238,138,13,0,100,250,351,388,739,100,53,0,3,93,206,193,262,455,4815,4876,842,875,3056,3190,8713,8941,17654
40601,182,379,626,713,1339,334,197,9,9,145,373,488,579,1067,129,73,3,3,127,362,259,438,697,9288,9500,2420,2499,7932,7648,19640,19647,39287
40602,90,132,216,215,431,79,47,0,0,55,129,134,176,310,27,14,0,0,33,75,60,89,149,3708,3815,1325,1395,3799,3471,8832,8681,17513
40701,171,379,932,942,1874,502,331,15,13,163,434,680,778,1458,277,136,7,4,173,424,457,564,1021,9473,9619,1667,1739,5321,6336,16461,17694,34155
40702,174,420,737,831,1568,403,216,5,6,167,482,575,704,1279,170,97,4,0,149,435,323,532,855,11685,11853,2362,2440,8204,8313,22251,22606,44857
40703,243,475,982,1016,1998,462,240,9,8,216,520,687,768,1455,211,87,7,3,185,590,403,680,1083,12308,12466,2388,2510,9479,9456,24175,24432,48607
49797,0,0,0,0,0,0,0,0,0,0,0,0,0,0,0,0,0,0,0,0,0,0,0,0,0,0,0,0,0,0,0,0
50101,88,244,448,542,990,252,166,6,0,91,268,349,434,783,133,53,3,3,87,267,223,323,546,7143,7589,1747,1889,4371,5242,13261,14720,27981
50102,192,472,838,968,1806,440,248,5,4,156,479,601,731,1332,222,78,3,3,155,463,380,544,924,16146,16932,3803,4110,11355,12059,31304,33101,64405
50103,68,119,263,249,512,107,59,0,0,47,106,154,165,319,58,18,0,0,40,125,98,143,241,4036,4201,878,937,2492,2497,7406,7635,15041
50201,266,602,1343,1451,2794,714,428,20,12,223,608,957,1048,2005,325,153,4,3,197,525,526,681,1207,14583,15494,3070,3467,9999,11774,27652,30735,58387
50301,132,431,701,874,1575,414,259,10,7,136,515,560,781,1341,277,146,3,3,172,746,452,895,1347,11709,12206,1501,1540,8570,10323,21780,24069,45849
50302,217,503,656,845,1501,305,188,3,3,186,541,494,732,1226,225,98,8,0,165,597,398,695,1093,12975,13336,4561,4533,15872,15860,33408,33729,67137
50401,248,585,877,1024,1901,392,245,8,8,172,523,572,776,1348,245,112,3,3,186,557,434,672,1106,12956,13273,2945,3081,12591,12999,28492,29353,57845
50402,108,182,430,429,859,200,94,0,4,78,215,278,313,591,98,43,0,0,60,246,158,289,447,7294,7665,1425,1559,4955,5479,13674,14703,28377
50403,175,386,688,746,1434,352,186,4,0,108,390,464,576,1040,146,63,0,0,111,311,257,374,631,17586,18439,3779,4116,13460,14572,34825,37127,71952
50501,221,675,1166,1417,2583,636,406,10,4,188,663,834,1073,1907,330,171,3,0,195,696,528,867,1395,30683,32075,4486,4813,19577,21592,54746,58480,113226
50502,498,1461,2051,2655,4706,1123,699,26,14,392,1363,1541,2076,3617,680,291,11,7,395,1480,1086,1778,2864,30391,31202,6266,6543,27320,31450,63977,69195,133172
50503,201,544,1022,1137,2159,463,265,7,4,154,484,624,753,1377,226,105,6,3,145,379,377,487,864,26938,28303,5576,6015,17952,20023,50466,54341,104807
50601,122,309,502,581,1083,218,146,6,5,109,267,333,418,751,106,41,0,0,95,224,201,265,466,10342,10778,2580,2773,8630,9067,21552,22618,44170
50602,192,459,554,753,1307,281,169,7,4,169,427,457,600,1057,165,77,0,0,140,455,305,532,837,9421,9671,2661,2792,11640,11243,23722,23706,47428
50603,180,543,797,972,1769,436,277,11,4,161,600,608,881,1489,253,133,7,3,161,648,421,784,1205,15593,16126,2227,2376,14868,15454,32688,33956,66644
50604,164,527,768,969,1737,394,219,11,3,159,425,564,647,1211,173,74,0,0,127,385,300,459,759,18328,19036,3559,3773,15230,15973,37117,38782,75899
50605,99,317,622,707,1329,296,175,4,4,71,233,371,412,783,152,60,6,0,71,298,229,358,587,10101,10621,1850,2029,6787,7454,18738,20104,38842
50606,26,42,106,108,214,60,33,0,0,18,39,78,72,150,19,8,3,0,16,26,38,34,72,3264,3483,743,810,1879,1928,5886,6221,12107
50607,71,276,294,446,740,164,122,3,0,69,285,236,407,643,119,58,0,0,100,383,219,441,660,6398,6612,1482,1538,6471,7478,14351,15628,29979
50701,170,455,759,834,1593,293,168,5,0,141,406,439,574,1013,112,47,3,3,110,353,225,403,628,15576,16266,3245,3511,11707,12667,30528,32444,62972
50702,121,263,414,486,900,205,122,6,0,92,268,303,390,693,114,38,3,0,75,255,192,293,485,5094,5260,1500,1631,5118,6108,11712,12999,24711
50703,61,140,221,237,458,94,61,3,0,35,91,132,152,284,37,27,0,0,30,90,67,117,184,4215,4413,1381,1520,3879,4105,9475,10038,19513
50704,209,709,1177,1492,2669,709,480,6,3,213,889,928,1372,2300,441,243,3,3,243,990,687,1236,1923,19155,19950,2445,2579,13548,17135,35148,39664,74812
50705,215,523,930,1059,1989,471,326,13,6,181,486,665,818,1483,225,93,7,4,153,410,385,507,892,17204,18542,4232,4744,12646,13750,34082,37036,71118
50801,33,93,139,182,321,73,44,0,0,37,70,110,114,224,33,18,0,0,21,70,54,88,142,2571,2671,638,687,1763,1701,4972,5059,10031
50802,30,34,76,66,142,27,11,3,6,29,22,59,39,98,8,3,0,0,14,26,22,29,51,1260,1307,510,542,1231,971,3001,2820,5821
50803,65,93,128,140,268,32,23,0,4,27,70,59,97,156,18,7,3,3,19,66,40,76,116,5201,5340,2114,2245,5193,4384,12508,11969,24477
50804,59,45,108,73,181,15,10,0,0,49,46,64,56,120,5,3,4,0,19,28,28,31,59,3055,3183,1917,2006,4462,4483,9434,9672,19106
50805,159,279,555,565,1120,249,124,5,5,128,232,382,361,743,100,42,3,0,87,206,190,248,438,8097,8614,2233,2489,6477,6614,16807,17717,34524
50806,19,32,40,44,84,8,5,0,0,13,19,21,24,45,3,0,0,0,12,14,15,14,29,5791,5849,2612,2672,5436,3659,13839,12180,26019
50901,166,379,688,739,1427,350,215,7,0,140,382,497,597,1094,174,83,10,3,125,371,309,457,766,9792,10051,2108,2268,6417,7250,18317,19569,37886
50902,182,258,695,615,1310,273,162,3,3,156,267,432,432,864,131,53,0,0,98,261,229,314,543,9694,10130,1926,2110,6212,5661,17832,17901,35733
50903,68,109,236,235,471,103,65,5,3,46,103,154,171,325,56,26,0,0,51,106,107,132,239,3749,3819,776,804,2295,2009,6820,6632,13452
59797,0,0,0,0,0,0,0,0,0,0,0,0,0,0,0,0,0,0,0,0,0,0,0,0,0,0,0,0,0,0,0,0
60101,25,58,100,102,202,37,15,3,0,12,47,52,62,114,11,7,0,0,14,37,25,44,69,2416,2454,781,810,1944,2386,5141,5650,10791
60102,146,384,604,721,1325,333,189,3,0,124,430,460,619,1079,190,116,0,0,131,411,321,527,848,8909,8987,1920,1978,6218,7971,17047,18936,35983
60103,191,533,618,858,1476,292,195,4,0,183,471,479,666,1145,152,71,4,4,160,501,316,576,892,7651,7741,2404,2455,7971,9789,18026,19985,38011
60104,59,198,311,405,716,196,103,6,3,56,211,258,317,575,93,38,3,0,53,210,149,248,397,6005,6080,1145,1186,3452,4594,10602,11860,22462
60105,112,336,456,591,1047,262,174,3,5,114,367,379,546,925,172,79,0,0,124,457,296,536,832,7385,7524,2091,2103,7897,9221,17373,18848,36221
60106,48,83,182,171,353,78,47,3,5,49,102,130,154,284,41,23,0,0,27,69,68,92,160,2639,2678,735,748,1933,2069,5307,5495,10802
60201,244,649,837,1164,2001,453,298,9,0,216,648,678,946,1624,260,130,4,3,196,713,460,846,1306,12955,13122,2973,2996,11273,14189,27201,30307,57508
60202,89,137,301,293,594,131,72,3,0,70,134,204,206,410,65,35,0,0,48,139,113,174,287,4418,4523,853,894,2532,2930,7803,8347,16150
60203,135,224,548,492,1040,199,114,3,4,105,256,307,374,681,84,37,0,0,97,207,181,244,425,6938,7011,1537,1566,4733,4727,13208,13304,26512
60301,39,52,122,97,219,39,24,0,0,28,46,67,70,137,13,0,0,0,19,47,32,47,79,2144,2138,548,558,1532,1232,4224,3928,8152
60302,63,105,249,205,454,98,50,3,4,40,74,141,128,269,41,18,0,0,37,69,78,87,165,3301,3342,898,920,2305,2187,6504,6449,12953
60303,36,55,122,110,232,39,22,0,0,37,34,76,56,132,21,10,0,0,10,42,31,52,83,1203,1210,317,318,833,699,2353,2227,4580
60401,156,427,646,796,1442,301,166,4,3,137,403,442,572,1014,165,76,7,3,113,379,285,458,743,8514,8719,1832,1927,5994,7604,16340,18250,34590
60402,140,353,558,637,1195,250,159,4,0,122,315,376,474,850,147,63,0,0,105,350,252,413,665,7762,7980,1648,1721,5432,6581,14842,16282,31124
60403,74,109,199,199,398,68,39,3,0,39,72,110,111,221,41,15,0,0,30,77,71,92,163,3126,3165,898,931,2395,2099,6419,6195,12614
69797,0,0,0,0,0,0,0,0,0,0,0,0,0,0,0,0,0,0,0,0,0,0,0,0,0,0,0,0,0,0,0,0
70101,42,42,105,71,176,35,18,0,0,35,44,70,62,132,16,3,0,0,10,37,26,40,66,2743,2829,1340,1380,3807,3128,7890,7337,15227
70102,73,150,231,242,473,63,25,0,0,51,124,114,149,263,26,7,0,0,34,71,60,78,138,7259,7468,2140,2271,7152,7163,16551,16902,33453
70103,26,28,68,55,123,31,16,0,0,23,15,54,31,85,6,8,0,0,6,16,12,24,36,2524,2680,986,1061,2302,1715,5812,5456,11268
70104,32,58,69,77,146,20,4,0,0,18,35,38,39,77,6,3,0,0,8,24,14,27,41,3579,3782,1611,1728,3338,3368,8528,8878,17406
70201,42,105,92,132,224,35,13,5,3,32,89,72,105,177,11,8,3,0,19,68,33,76,109,4393,4498,1522,1644,4794,5484,10709,11626,22335
70202,5,13,9,17,26,3,0,0,0,7,10,10,10,20,0,0,0,0,5,9,5,9,14,625,632,207,213,815,902,1647,1747,3394
70203,20,23,33,35,68,10,7,0,0,11,12,21,19,40,6,0,0,0,6,6,12,6,18,1775,1778,637,649,2392,2258,4804,4685,9489
70204,4,23,11,23,34,0,0,0,0,4,13,4,13,17,0,0,0,0,5,11,5,11,16,1837,1819,339,336,2049,2045,4225,4200,8425
70205,33,34,69,43,112,11,0,0,3,24,23,35,26,61,3,0,0,0,10,17,13,17,30,2141,2204,709,758,2231,2289,5081,5251,10332
79797,0,0,0,0,0,0,0,0,0,0,0,0,0,0,0,0,0,0,0,0,0,0,0,0,0,0,0,0,0,0,0,0
80101,172,415,710,788,1498,335,196,4,6,125,375,464,577,1041,172,84,3,3,103,426,278,513,791,16341,16513,3521,3591,12957,14427,32819,34531,67350
80102,0,5,3,5,8,0,0,0,0,0,3,0,3,3,0,0,0,0,0,0,0,0,0,87,91,30,27,82,55,199,173,372
80103,11,5,16,9,25,5,5,0,0,7,6,12,11,23,3,3,0,0,0,0,3,3,6,137,140,47,49,301,158,485,347,832
80104,29,93,160,171,331,57,31,3,0,28,65,88,96,184,31,8,0,0,13,59,44,67,111,8993,9179,1767,1815,5406,6239,16166,17233,33399
80105,124,270,393,506,899,254,154,6,0,102,278,362,432,794,164,77,0,0,95,307,259,384,643,5837,5914,2284,2340,7630,8337,15751,16591,32342
80106,50,154,205,265,470,136,118,3,0,45,173,184,291,475,111,54,3,0,73,256,187,310,497,3990,4058,976,1001,3659,4206,8625,9265,17890
80107,79,299,456,589,1045,208,123,5,0,70,294,283,417,700,112,52,3,3,68,244,183,299,482,16030,16260,3210,3285,12013,13673,31253,33218,64471
80108,55,150,281,302,583,124,66,5,0,43,134,172,200,372,61,41,0,0,45,175,106,216,322,4466,4499,733,738,2852,3572,8051,8809,16860
80109,90,257,437,533,970,257,148,0,0,77,245,334,393,727,155,73,3,0,85,250,243,323,566,6155,6229,1087,1095,4695,5586,11937,12910,24847
89797,0,0,0,0,0,0,0,0,0,0,0,0,0,0,0,0,0,0,0,0,0,0,0,0,0,0,0,0,0,0,0,0
90101,4,0,4,0,4,0,3,3,0,0,0,3,3,6,0,0,0,0,0,0,0,0,0,257,261,32,30,222,109,511,400,911
90102,4,3,4,6,10,3,0,0,0,0,3,3,3,6,0,0,3,0,3,0,6,0,6,153,155,6,7,42,29,201,191,392
90103,0,4,0,7,7,0,0,0,0,0,3,0,3,3,0,0,0,0,0,0,0,0,0,28,27,10,8,55,60,93,95,188
99797,0,0,0,0,0,0,0,0,0,0,0,0,0,0,0,0,0,0,0,0,0,0,0,0,0,0,0,0,3,0,3,3
