region_id,2011_Census_All_incomes_not_stated_One_parent_family_with_One_child,2011_Census_All_incomes_not_stated_One_parent_family_with_Two_children,2011_Census_All_incomes_not_stated_One_parent_family_with_Three_children,2011_Census_All_incomes_not_stated_One_parent_family_with_Four_or_more_children,2011_Census_All_incomes_not_stated_One_parent_family_with_Total,2011_Census_Total_One_parent_family_with_One_child,2011_Census_Total_One_parent_family_with_Two_children,2011_Census_Total_One_parent_family_with_Three_children,2011_Census_Total_One_parent_family_with_Four_or_more_children,2011_Census_Total_One_parent_family_with_Total
10101,42,21,0,7,70,1587,770,310,103,2770
10102,31,16,8,3,58,1152,597,198,76,2023
10103,15,3,3,0,21,395,187,64,21,667
10104,57,28,11,11,107,1624,859,286,158,2927
10201,108,46,18,10,182,4453,2318,842,248,7861
10202,142,63,38,12,255,4679,2562,983,444,8668
10301,28,14,6,3,51,977,505,223,102,1807
10302,52,23,15,6,96,1268,633,278,137,2316
10303,32,21,6,0,59,1116,515,189,91,1911
10304,40,19,20,12,91,1289,638,260,155,2342
10401,45,20,12,5,82,1333,697,279,129,2438
10402,57,36,16,7,116,2391,1243,438,196,4268
10501,53,26,10,11,100,677,291,157,116,1241
10502,28,12,7,5,52,650,318,145,65,1178
10503,90,34,18,9,151,1716,943,408,253,3320
10601,70,41,15,3,129,2174,1144,450,189,3957
10602,45,23,10,7,85,1573,924,306,146,2949
10603,49,22,17,4,92,1689,904,350,135,3078
10604,24,12,5,4,45,629,346,136,73,1184
10701,70,47,4,8,129,2003,1151,407,192,3753
10702,0,0,0,0,0,0,0,0,0,0
10703,66,26,11,14,117,2202,1236,427,201,4066
10704,87,28,11,0,126,3028,1581,457,126,5192
10801,34,12,0,0,46,799,384,142,75,1400
10802,63,24,10,6,103,1410,746,318,204,2678
10803,0,0,0,0,0,6,4,0,0,10
10804,56,20,5,6,87,1895,1017,325,126,3363
10805,52,18,12,9,91,1413,717,257,161,2548
10901,43,20,4,3,70,1411,720,282,131,2544
10902,22,6,4,3,35,256,125,62,25,468
10903,40,21,5,0,66,779,403,170,67,1419
11001,26,8,10,3,47,812,389,171,95,1467
11002,36,21,7,0,64,874,443,222,126,1665
11003,38,17,6,9,70,586,316,138,89,1129
11004,76,33,16,6,131,2050,1044,433,238,3765
11101,103,40,17,5,165,3303,1629,565,199,5696
11102,60,20,7,7,94,1846,1071,371,153,3441
11103,137,33,24,10,204,4458,2076,633,244,7411
11201,52,20,6,9,87,2374,1082,320,96,3872
11202,58,30,10,13,111,2114,1038,401,192,3745
11203,64,38,5,5,112,2476,1261,419,167,4323
11301,44,18,5,8,75,964,515,222,122,1823
11302,8,3,0,3,14,297,162,56,26,541
11303,61,22,20,13,116,2053,1033,432,231,3749
11401,89,29,8,8,134,2442,1301,464,201,4408
11402,25,14,6,0,45,1029,537,179,85,1830
11501,27,24,7,0,58,2028,1310,391,91,3820
11502,11,12,0,0,23,374,236,103,34,747
11503,8,4,3,0,15,400,227,92,31,750
11504,6,6,0,0,12,377,241,105,23,746
11601,108,57,18,19,202,3471,1912,699,342,6424
11602,31,23,4,9,67,1291,871,285,119,2566
11603,148,69,27,36,280,3224,1948,942,677,6791
11701,27,14,0,3,44,1119,540,123,45,1827
11702,26,17,3,0,46,1320,520,121,56,2017
11703,71,28,9,4,112,2747,901,202,71,3921
11801,39,21,5,0,65,2167,886,216,39,3308
11802,93,17,3,3,116,2971,1226,282,69,4548
11901,110,70,33,27,240,4147,2355,888,468,7858
11902,108,49,35,10,202,3352,1574,535,239,5700
11903,64,24,5,0,93,2898,1392,372,139,4801
11904,74,26,13,7,120,3145,1366,424,155,5090
12001,22,17,5,0,44,1586,715,160,31,2492
12002,17,3,3,0,23,1182,406,77,24,1689
12003,71,24,6,5,106,3495,1404,334,90,5323
12101,27,8,3,3,41,2067,871,205,36,3179
12102,29,17,3,0,49,1635,829,239,51,2754
12103,29,11,5,0,45,1651,994,273,67,2985
12104,22,4,0,0,26,1544,569,120,17,2250
12201,14,4,0,0,18,692,317,92,12,1113
12202,19,15,0,3,37,1105,580,168,33,1886
12203,83,29,4,4,120,2863,1433,363,87,4746
12301,25,8,7,5,45,968,653,287,93,2001
12302,149,77,37,28,291,4448,2626,1110,560,8744
12303,26,14,4,4,48,733,418,173,85,1409
12401,24,13,6,3,46,1824,953,276,119,3172
12402,0,0,0,0,0,0,0,0,0,0
12403,120,45,20,6,191,3346,1842,692,283,6163
12404,37,7,9,3,56,1076,609,221,79,1985
12405,58,25,7,9,99,1652,916,366,174,3108
12501,54,18,10,14,96,1580,799,306,157,2842
12502,31,18,8,0,57,1400,685,222,75,2382
12503,101,48,28,19,196,3547,1906,794,469,6716
12504,87,26,17,6,136,2800,1260,355,148,4563
12601,8,3,0,0,11,782,396,84,20,1282
12602,47,18,10,0,75,2600,1145,274,57,4076
12701,87,47,28,10,172,1781,1264,543,263,3851
12702,160,108,47,28,343,5216,3405,1270,593,10484
12703,81,44,10,5,140,2478,1489,557,251,4775
12801,58,29,7,0,94,2503,1199,317,85,4104
12802,32,13,6,4,55,2023,1193,394,97,3707
19797,0,0,0,0,0,0,0,0,0,0
20101,69,35,17,13,134,2516,1317,522,215,4570
20102,20,6,9,0,35,627,314,96,31,1068
20103,18,8,10,4,40,591,257,123,44,1015
20201,64,36,19,7,126,2450,1284,465,198,4397
20202,23,9,4,0,36,961,504,158,68,1691
20203,7,3,3,3,16,228,87,43,17,375
20301,17,0,0,0,17,260,130,52,22,464
20302,151,69,23,13,256,4634,2548,836,316,8334
20303,26,6,5,4,41,1165,663,264,67,2159
20401,51,11,7,3,72,1140,584,210,76,2010
20402,27,19,3,0,49,1066,545,217,74,1902
20403,30,21,14,4,69,1517,865,274,117,2773
20501,36,18,9,5,68,950,521,205,79,1755
20502,39,18,6,4,67,942,510,188,74,1714
20503,27,21,3,5,56,1223,600,236,76,2135
20504,76,26,14,11,127,2006,1061,398,200,3665
20505,32,11,8,3,54,852,513,215,73,1653
20601,46,16,5,0,67,1688,662,163,55,2568
20602,41,10,3,0,54,1067,423,101,16,1607
20603,53,17,12,5,87,1291,656,163,60,2170
20604,32,13,11,6,62,1307,457,113,42,1919
20605,21,15,4,0,40,1738,599,121,26,2484
20606,19,13,0,0,32,900,367,79,24,1370
20607,32,21,5,8,66,1623,664,160,82,2529
20701,57,22,4,3,86,2811,1433,383,70,4697
20702,35,11,3,0,49,1866,941,245,63,3115
20703,40,8,3,0,51,2209,1015,249,53,3526
20801,45,22,3,0,70,1926,959,257,52,3194
20802,60,19,10,3,92,2851,1235,318,72,4476
20803,69,20,5,3,97,2666,1280,340,80,4366
20804,9,3,3,3,18,630,300,90,22,1042
20901,78,42,9,6,135,2996,1434,454,138,5022
20902,93,32,6,6,137,2469,1025,306,120,3920
20903,22,13,3,0,38,1046,735,220,58,2059
20904,120,80,31,9,240,3804,2360,877,291,7332
21001,48,13,5,3,69,1339,755,197,34,2325
21002,19,0,0,0,19,425,265,110,36,836
21003,54,15,8,9,86,1858,805,252,106,3021
21004,28,8,3,3,42,897,535,180,57,1669
21005,110,68,28,28,234,3149,2061,845,422,6477
21101,89,49,17,6,161,3393,2033,625,193,6244
21102,7,4,0,0,11,388,235,74,19,716
21103,72,31,7,4,114,2660,1423,430,131,4644
21104,32,6,5,0,43,1298,634,157,58,2147
21105,85,39,17,3,144,3294,1948,655,195,6092
21201,48,23,12,3,86,1509,942,378,142,2971
21202,80,47,11,11,149,2664,1717,605,275,5261
21203,107,55,14,13,189,2830,1869,734,295,5728
21204,150,92,23,38,303,4658,2422,739,392,8211
21205,94,26,10,5,135,3566,1724,422,113,5825
21301,187,114,56,35,392,4764,2879,1115,507,9265
21302,55,26,8,3,92,2081,985,298,71,3435
21303,46,16,6,10,78,1763,876,234,111,2984
21304,93,60,18,12,183,2743,1861,703,315,5622
21305,108,40,21,33,202,3716,2331,889,386,7322
21401,125,59,21,8,213,3907,2118,706,235,6966
21402,93,48,14,11,166,3336,1886,644,184,6050
21501,49,18,12,3,82,1310,607,230,108,2255
21502,56,31,17,9,113,1244,766,305,135,2450
21503,31,17,5,7,60,710,372,153,75,1310
21601,28,13,3,0,44,840,436,197,72,1545
21602,25,5,0,3,33,578,283,115,60,1036
21603,69,20,24,3,116,1377,812,359,154,2702
21701,24,10,8,4,46,811,366,151,45,1373
21702,64,23,10,6,103,1892,944,381,155,3372
29797,0,0,0,0,0,0,0,0,0,0
30101,34,23,3,3,63,1683,954,305,110,3052
30102,53,11,8,4,76,1636,902,296,146,2980
30103,36,18,3,0,57,1756,956,253,93,3058
30201,16,7,3,0,26,823,404,122,26,1375
30202,59,31,9,3,102,1833,808,273,91,3005
30203,18,9,7,0,34,934,379,110,43,1466
30204,35,16,7,4,62,1606,710,228,89,2633
30301,31,9,0,0,40,1114,535,147,54,1850
30302,39,13,3,3,58,1446,601,122,55,2224
30303,45,15,9,0,69,1516,719,234,89,2558
30304,15,13,3,0,31,888,400,122,46,1456
30305,28,21,7,3,59,1094,665,212,118,2089
30306,19,8,3,4,34,1082,554,171,74,1881
30401,13,0,0,0,13,590,353,108,32,1083
30402,10,6,0,0,16,639,422,142,37,1240
30403,8,4,3,0,15,759,343,80,21,1203
30404,26,14,7,4,51,1086,590,188,58,1922
30501,17,4,0,0,21,877,291,62,11,1241
30502,16,6,0,0,22,789,323,75,18,1205
30503,27,11,0,0,38,1504,598,143,32,2277
30504,19,9,3,0,31,906,385,98,23,1412
30601,22,12,5,0,39,1170,636,229,58,2093
30602,105,63,40,33,241,2694,1446,563,371,5074
30603,41,12,8,3,64,840,423,156,118,1537
30604,13,3,0,3,19,240,106,34,13,393
30605,45,22,14,3,84,992,477,217,103,1789
30701,33,23,3,3,62,750,396,137,82,1365
30702,33,15,9,0,57,775,376,177,101,1429
30703,29,24,4,4,61,867,425,189,101,1582
30801,15,10,0,3,28,372,217,80,58,727
30802,48,23,13,3,87,1350,651,274,106,2381
30803,114,39,18,13,184,2689,1359,559,240,4847
30901,35,21,3,0,59,1663,631,165,41,2500
30902,39,13,7,3,62,1580,729,209,70,2588
30903,54,17,3,0,74,1978,790,208,54,3030
30904,13,0,0,0,13,368,187,55,29,639
30905,16,9,0,0,25,689,430,144,49,1312
30906,42,22,3,3,70,1602,925,295,99,2921
30907,33,22,10,5,70,1893,1231,470,169,3763
30908,26,6,3,3,38,1235,771,207,61,2274
30909,44,18,6,3,71,1656,758,199,67,2680
30910,13,9,3,0,25,830,292,71,15,1208
31001,53,28,15,12,108,1791,1027,379,211,3408
31002,41,20,14,6,81,1274,658,283,145,2360
31003,79,37,13,16,145,2609,1519,594,306,5028
31004,39,30,14,12,95,1787,1027,447,265,3526
31101,10,5,3,3,21,319,157,86,35,597
31102,37,24,6,4,71,1247,680,230,134,2291
31103,79,35,17,13,144,1983,1148,492,273,3896
31104,28,12,0,0,40,632,323,149,60,1164
31105,41,14,3,6,64,1408,817,315,123,2663
31106,87,48,17,25,177,2484,1251,506,319,4560
31201,19,14,8,3,44,510,237,94,50,891
31202,82,41,7,4,134,2240,1121,453,175,3989
31203,16,5,0,0,21,359,171,45,29,604
31301,21,12,6,3,42,749,385,134,57,1325
31302,62,39,25,12,138,1703,1025,457,248,3433
31303,8,3,3,3,17,231,137,54,20,442
31304,45,25,16,7,93,1453,810,336,167,2766
31305,40,16,10,3,69,1821,823,268,112,3024
31401,36,14,3,0,53,1320,874,249,75,2518
31402,23,17,6,4,50,1166,749,243,76,2234
31403,35,12,9,3,59,1029,533,172,81,1815
31501,48,14,6,8,76,771,386,196,166,1519
31502,39,9,13,7,68,593,286,161,123,1163
31503,20,13,3,3,39,398,153,82,48,681
31601,17,3,0,4,24,957,560,172,64,1753
31602,48,21,8,3,80,1766,922,289,83,3060
31603,31,16,7,0,54,1559,710,192,65,2526
31604,45,21,6,4,76,1411,750,270,100,2531
31605,13,14,3,0,30,939,478,154,49,1620
31606,36,8,3,3,50,1040,555,207,79,1881
31701,84,38,19,7,148,3151,1712,653,332,5848
31801,39,22,5,3,69,927,464,204,128,1723
31802,126,71,27,18,242,4119,2272,828,431,7650
31901,62,41,12,10,125,2150,1148,459,231,3988
31902,57,23,4,7,91,1104,523,228,163,2018
31903,46,17,10,10,83,1085,584,251,129,2049
31904,52,22,11,5,90,1467,760,327,130,2684
31905,38,22,8,7,75,1089,542,218,129,1978
39797,0,0,0,0,0,0,0,0,0,0
40101,7,4,0,0,11,259,79,14,4,356
40102,25,10,4,3,42,1266,781,226,64,2337
40103,10,6,0,0,16,813,423,103,25,1364
40104,16,8,8,3,35,1151,629,191,44,2015
40105,20,8,0,3,31,856,339,79,18,1292
40106,13,3,0,0,16,566,230,67,24,887
40107,11,0,0,3,14,729,322,91,12,1154
40201,19,5,0,0,24,748,478,156,47,1429
40202,101,70,30,23,224,2834,1603,667,339,5443
40203,36,18,14,9,77,1748,885,301,145,3079
40204,91,61,27,21,200,3805,2171,739,333,7048
40205,44,19,6,3,72,2203,1249,419,97,3968
40301,10,7,0,0,17,778,274,52,20,1124
40302,57,8,8,3,76,2396,1101,292,90,3879
40303,19,4,0,0,23,1205,669,183,37,2094
40304,85,53,16,9,163,4446,2464,788,276,7974
40401,62,34,7,5,108,2910,1322,427,167,4826
40402,64,32,10,10,116,1890,902,288,123,3203
40403,23,4,5,3,35,1434,595,151,48,2228
40501,11,3,3,0,17,608,300,137,40,1085
40502,17,3,4,3,27,393,212,89,44,738
40503,21,4,5,3,33,646,327,150,60,1183
40504,29,5,4,3,41,487,257,86,42,872
40601,57,16,17,8,98,1373,679,244,140,2436
40602,31,12,10,4,57,611,292,145,68,1116
40701,28,7,0,3,38,927,478,169,56,1630
40702,54,15,10,3,82,1411,724,255,110,2500
40703,57,32,5,8,102,1547,833,273,169,2822
49797,0,0,0,0,0,0,0,0,0,0
50101,21,12,0,0,33,849,512,164,44,1569
50102,57,29,15,6,107,2033,1197,435,155,3820
50103,11,7,3,0,21,414,232,76,39,761
50201,63,20,13,10,106,1932,1065,440,180,3617
50301,12,5,0,0,17,932,543,200,36,1711
50302,24,3,3,0,30,1508,584,130,30,2252
50401,62,12,3,9,86,2028,893,247,94,3262
50402,24,14,4,3,45,863,469,201,67,1600
50403,70,30,26,16,142,2399,1430,519,252,4600
50501,45,19,8,0,72,2966,1750,531,138,5385
50502,94,66,28,19,207,4287,2032,560,230,7109
50503,87,33,21,21,162,3180,1976,719,353,6228
50601,49,25,11,7,92,1675,922,319,149,3065
50602,48,22,17,8,95,1581,645,194,105,2525
50603,32,18,9,8,67,1807,931,322,97,3157
50604,68,40,17,13,138,2545,1409,510,226,4690
50605,19,11,5,0,35,1088,702,222,79,2091
50606,10,3,0,0,13,280,174,81,27,562
50607,17,5,3,3,28,816,341,97,34,1288
50701,56,18,15,6,95,2042,1097,346,141,3626
50702,10,7,4,0,21,861,381,103,31,1376
50703,31,13,3,5,52,795,458,162,61,1476
50704,38,11,6,0,55,1943,1074,290,67,3374
50705,82,30,9,4,125,2287,1328,505,220,4340
50801,13,7,0,0,20,296,160,40,37,533
50802,16,6,3,3,28,187,76,47,30,340
50803,46,23,11,6,86,764,408,174,73,1419
50804,26,28,6,17,77,750,447,237,187,1621
50805,45,36,15,16,112,1090,682,258,137,2167
50806,37,23,10,4,74,572,272,123,76,1043
50901,36,14,5,10,65,1141,642,226,110,2119
50902,33,17,11,8,69,918,501,176,124,1719
50903,16,5,4,7,32,368,152,59,41,620
59797,0,0,0,0,0,0,0,0,0,0
60101,25,9,6,3,43,553,341,123,73,1090
60102,33,13,3,7,56,1388,774,230,97,2489
60103,60,32,14,3,109,1805,885,317,137,3144
60104,12,3,0,3,18,710,409,134,48,1301
60105,20,5,3,0,28,1086,457,124,41,1708
60106,6,3,3,3,15,387,208,70,21,686
60201,50,30,13,8,101,2201,1129,414,145,3889
60202,5,6,3,0,14,427,211,79,36,753
60203,22,16,4,3,45,848,392,141,73,1454
60301,7,3,0,3,13,227,103,43,25,398
60302,14,4,3,0,21,413,204,70,25,712
60303,4,0,3,0,7,134,42,19,6,201
60401,36,19,6,8,69,1266,666,253,120,2305
60402,37,17,0,3,57,1152,590,216,95,2053
60403,14,8,0,0,22,365,180,67,27,639
69797,0,0,0,0,0,0,0,0,0,0
70101,7,5,4,0,16,360,147,40,13,560
70102,63,20,11,5,99,1197,612,241,125,2175
70103,3,6,3,4,16,307,183,65,22,577
70104,15,5,4,3,27,630,386,175,69,1260
70201,55,32,15,7,109,795,444,210,115,1564
70202,17,13,7,10,47,125,71,45,50,291
70203,6,3,0,3,12,323,208,100,106,737
70204,6,5,0,3,14,300,194,95,105,694
70205,16,8,9,3,36,347,180,120,105,752
79797,0,0,0,0,0,0,0,3,0,3
80101,20,18,9,3,50,2020,1134,337,105,3596
80102,0,0,0,0,0,12,6,0,0,18
80103,0,0,0,0,0,32,9,3,0,44
80104,10,6,4,3,23,828,532,156,48,1564
80105,17,4,0,0,21,911,349,82,27,1369
80106,8,5,3,3,19,467,221,61,24,773
80107,28,17,3,5,53,2168,1430,449,157,4204
80108,8,4,0,0,12,535,269,80,19,903
80109,14,7,3,0,24,657,344,105,21,1127
89797,0,0,0,0,0,0,0,0,3,3
90101,0,0,0,0,0,18,12,3,0,33
90102,0,0,0,0,0,10,0,0,0,10
90103,0,0,0,0,0,9,12,6,3,30
99797,0,0,0,0,0,0,0,0,0,0
